aibaixu	æːbɪːx
aibalǰaxu	æːbɑlʤɪx
aiburlaxu	æːbɑrlɑx
aixu	æːx
aigudxaxu	æːɡʊːtɡɑx
aimaxu	æːmɑx
aimaglaxu	æːmɑɡlɑx
aimagčilaxu	æːmɑɡʧlɑx
aimasxu	æːmsɑx
aimurxu	æːmrɑx
aimurlaxu	æːmɑrlɑx
ailadxaxu	æːltɡɑx
ailadxu	æːldɑx
ailuglaxu	æːlɑɡlɑx
ailgaxu	æːlɡɑx
ailsaxu	æːlsɑx
ailsixu	æːlʃɪx
ailčilaxu	æːlʧlɑx
aisuxu	æːsɑx
aidaŋguilaxu	æːdɑŋɡʊɪlɑx
aidaŋguiraxu	æːdɑŋɡʊɪrɑx
aidaŋgulaxu	æːdɑŋɡɑlɑx~æːdɑŋɡʊːlɑx
aidaŋguraxu	æːdɑŋɡɑrɑx~æːdɑŋɡʊːrɑx
aidarlaxu	æːdɑrlɑx
aiǰagalaxu	æːʤɑːlɑx
aiǰamlaxu	æːʤɪmlɑx
airaglaxu	æːrɑɡlɑx
airaglagulxu	æːrɑɡlʊːlɑx
airagsixu	æːrɑɡʃɪx
airalǰilaxu	æːrɑlʤlɑx
aü't'omat'čilaxu	ɑʊtmɑːtʧɪlɑx
aü't'očilaxu	ɑʊtʧɪlɑx
anaxu	ɑnɑx
anagaxu	ɑnɡɑːx
aniixu	ænɪːx
aniilgaxu	ænɪːlɡɑx
anibalǰaxu	ænbɑlʤɪx
anibasxixü	ænbɑsxiːx
anibxixü	ænɪbxiːx
anibčixu	ænɪbʧɪx
anibčilaxu	ænɪbʧlɑx
anixu	ænɪx
aniganaxu	ænɡɑnɑx
anigulxu	ænɪʊlɑx
anilxilaxu	ænɪlxiːləx
anilduxu	ænɪldɑx
anilǰaxu	ænɪlʤɪx
anirlaxu	ænɪrlɑx
anirsixu	ænɪrʃɪx
anirtuxu	ænɪrtɑx
andaixu	ɑndɪːx
andaxu	ɑndɑx
andagailaxu	ɑndɡæːlɑx
andaganaxu	ɑndɡɑnɑx
andagarlaxu	ɑndɡɑrlɑx
andagulxu	ɑndʊːlɑx
andaguraxu	ɑndʊːrɑx
andalaxu	ɑndlɑx
andalǰaxu	ɑndɑlʤɪx
anduxu	ɑndɑx
andulduxu	ɑndɑldɑx
ančiixu	ɑnʧɪːx
ančilaxu	ɑnʧlɑx
anǰisudaxu	ɑnʤɪsdɑx
anǰulaxu	ɑnʤlɑx
aŋnaxu	ɑɡnɑx
aŋxarugulxu	ɑŋxɑːrʊːlɑx
aŋxarxu	ɑŋxɑːrɑx
aŋxilxu	æŋxlɑx
aŋxuixu	ɑŋxɪːx
aŋgaixu	ɑŋɡæːx
aŋgailgaxu	ɑŋɡæːlɡɑx
aŋgabalǰaxu	ɑŋɡɑbɑlʤɪx
aŋgaxu	ɑŋɡɑx
aŋgaganaxu	ɑŋɡɑɡɑnɑx
aŋgalaxu	ɑŋɡɑlɑx
aŋgalǰaxu	ɑŋɡɑlʤɪx
aŋgaraituxu	ɑŋɡɑræːtɑx
aŋgilaxu	æŋɡɪlɑx
aŋgidxu	æŋɡɪdɑx
aŋgiǰiraxu	æŋɡɪʤrɑx
aŋgiǰiragulxu	æŋɡɪʤrʊːlɑx
aŋgirsixu	æŋɡɪrʃɪx
aŋgučilaxu	ɑŋɡʊːʧlɑx
aŋsaixu	ɑŋsɪːx
aŋsaganaxu	ɑŋsɡɑnɑx
aŋsalǰaxu	ɑŋsɑlʤɪx
aŋtuxu	ɑŋtɑx
aŋčilaxu	ɑŋʧlɑx
aŋǰagaraxu	ɑŋʤɑːrɑx
abagailaxu	ɑbɡæːlɑx
abagaraxu	ɑbɑːrɑx
abagaralduxu	ɑbɑːrɑldɑx
abalaxu	ɑblɑx
abačixu	ɑbɑːʧɪx
abarixu	æbrɑx
abiyalaxu	ɑbjɑːlɑx
abiyasurxaxu	ɑbjɑːsɑrxɑx
abiyaslaxu	ɑbjɑːslɑx
abiyačilaxu	ɑbjɑːʧlɑx
abiyarxaxu	ɑbjɑːrxɑx
abuŋxailaxu	ɑbɑŋxæːlɑx
abugailaxu	ɑbɡæːlɑx
abugairxaxu	ɑbɡæːrxɑx
abugulxu	ɑbʊːlɑx
abugdaxu	ɑbɑɡdɑx
abulčaxu	ɑbɑlʧɪx
abulčagulxu	ɑbɑlʧʊːlɑx
abučalduxu	ɑbʧɪldɑx
aburaxu	ɑbrɑx
aburaldaxu	ɑbrɑldɑx
aburilaxu	æbɪrlɑx
aburxaxu	ɑːbɑrxɑx
abxagulxu	ɑbxʊːlɑx
abxalǰilaxu	ɑbxɑlʤlɑx
abxu	ɑbɑx
abligalaxu	ɑblɪɡlɑx
absalaxu	ɑbslɑx
absarlaxu	ɑbsɑːrlɑx
abtaxu	ɑbtɑx
abtagdaxu	ɑbtɑɡdɑx
abtasxixü	ɑbtɑsxiːx
abdaralaxu	ɑbdɑrlɑx
abčaxu	ɑbʧɪx
abčalduxu	ɑbʧɪldɑx
abčaldugulxu	ɑbʧɪldʊːlɑx
abčixu	ɑbʧɪx
abčigulxu	ɑbʧʊːlɑx
abčiguraxu	ɑbʧʊːrɑx
abčiraxu	ɑbʧrɑx
abǰagalaxu	ɑbʤɑːlɑx
axalaxu	ɑxlɑx
axasiraxu	ɑxʃrɑx
axasčilaxu	ɑxɑsʧlɑx
axadaxu	ɑxdɑx
axačilaxu	ɑxʧlɑx
axarxaxu	ɑxɑrxɑx
axiixu	æxɪːx
axixu	æxɪx
axigulxu	æxɪʊlɑx
axiglaxu	æxɪɡlɑx
axiyadalaxu	æxɪɑdlɑx
axu	ɑx~ɑːx
axugulxu	ɑxʊːlɑx
axurlaxu	ɑxɑrlɑx
axurtuxu	ɑxɑrtɑx
axurčilaxu	ɑxɑrʧlɑx
agaxilaxu	æːxlɑx
agagixu	ɑːɡɪx
agaglaxu	ɑːɡlɑx
agalilaxu	ɑːlʲlɑx
agalidxu	ɑːlʲtɑx
agalirxaxu	ɑːlɪrxɑx
agasixu	ɑːɡʃɪx
agasigulxu	ɑːɡʃʊːlɑx
agasilaxu	ɑːʃlɑx
agadaixu	ɑːdɪːx
agadaganaxu	ɑːdɡɑnɑx
agadalǰaxu	ɑːdɑlʤɪx
agadarlaxu	ɑːdɑrlɑx
agaǰigulaxu	ɑːʤʊːlɑx
agaǰigudaxu	ɑːʤʊːdɑx
agaǰigudxaxu	ɑːʤʊːtɡɑx
agaǰigudxu	ɑːʤʊːtɑx
agaǰiguraxu	ɑːʤʊːrɑx
agaǰimlaxu	ɑːʤɪmlɑx
agaǰimtuxu	ɑːʤɪmtɑx
agaǰimdaxu	ɑːʤɪmdɑx
agaraxu	ɑːrɑx
agariglaxu	ɑːrɪɡlɑx
agarmaglaxu	ɑːrmɑɡlɑx
agixu	æɡɪx
agilagudxu	æɡlʊːtɑx
agiraxu	æɡrɑx
agiragulxu	æɡrʊːlɑx
agiragusxu	æɡrʊːsɑx
agiragudxu	æɡrʊːtɑx
aguxu	ʊːx
agulalaxu	ʊːllɑx
agulxu	ɑɡʊːlɑx~ʊːlɑx
agulgaxu	ʊːlɡɑx
agulǰaxu	ʊːlʤɪx
agusxaxu	ʊːsɡɑx
agusxu	ʊːsɑx
agudamčilaxu	ʊːdɑmʧlɑx
agudalxu	ʊːdlɑx
agučilaxu	ʊːʧlɑx
aguǰiguraxu	ʊːʤʊːrɑx
aguǰimtuxu	ʊːʤɪmtɑx
aguǰimdaxu	ʊːʤɪmdɑx
aguǰiraxu	ʊːʤrɑx
agurlaxu	ʊːrlɑx
agursaxu	ʊːrsɑx
agursixu	ʊːrʃɪx
agursigulxu	ʊːrʃʊːlɑx
agligudxu	ɑɡlɪʊtɑx
agsaixu	ɑɡsɪːx
agsaxu	ɑɡsɑx
agsaganaxu	ɑɡsɡɑnɑx
agsagadaxu	ɑɡsɑːdɑx
agsalǰaxu	ɑɡsɑlʤɪx
agsixu	ɑɡʃɪx
agsigaxu	ɑɡʃɑːx
agsiguraxu	ɑɡʃʊːrɑx
agsiraxu	ɑɡʃrɑx
agsuxu	ɑɡsɑx
agsugulxu	ɑɡsʊːlɑx
agsumnaxu	ɑɡsɑmnɑx
agsučixu	ɑɡsʧɪx
agsurxilaxu	ɑɡsɑrxiːləx
agsurxu	ɑɡsrɑx
agtagalaxu	ɑɡtɑːlɑx
agtalaxu	ɑɡtlɑx
agdaganaxu	ɑɡdɡɑnɑx
agdagalǰaxu	ɑɡdɡɑlʤɪx
agduixu	ɑɡdɪːx
agduilgaxu	ɑɡdɪːlɡɑx
agduganaxu	ɑɡdɡɑnɑx
agdulaxu	ɑɡdlɑx
agdulǰaxu	ɑɡdɑlʤɪx
agdusxixü	ɑɡdɑsxiːx
agǰaixu	ɑɡʤɪːx
agǰaganaxu	ɑɡʤɡɑnɑx
agǰalǰaxu	ɑɡʤɪlʤɪx
agǰasxixü	ɑɡʤɪsxiːx
amagaibčilaxu	ɑmɡæːbʧlɑx
amagailaxu	ɑmɡæːlɑx
amagaisaxu	ɑmɡæːsɑx
amagaituxu	ɑmɡæːtɑx
amagaičilaxu	ɑmɡæːʧlɑx
amalaxu	ɑmlɑx
amaldaxu	ɑmɑldɑx
amasarlaxu	ɑmsɑrlɑx
amasardaxu	ɑmsɑrdɑx
amadaxu	ɑmdɑx
amarautuxu	ɑmrʊːtɑx
amaraxu	ɑmrɑx
amaragaxu	ɑmrɑːx
amaragulxu	ɑmrʊːlɑx
amaraglaxu	ɑmrɑɡlɑx
aminčilaxu	æmɪnʧlɑx
aminčirxaxu	æmɪnʧɪrxɑx
amilaxu	æmlɑx
amisxuxu	æmsɡɑx
amisxugalaxu	æmsɡɑːlɑx
amisxugadaxu	æmsɡɑːdɑx
amisxugulxu	æmsɡʊːlɑx
amisxullaxu	æmsɡɑllɑx
amidaxu	æmdɑx
amidučilaxu	æmdʧɪlɑx
amiduraxu	æmdrɑx
amiǰixu	æmʤɪx
amiyatuxu	ɑmjɑːtɑx
amiyadaxu	ɑmjɑːdɑx
amirxaxu	æmɪrxɑx
amuxu	ɑmɑx
amugulxu	ɑmʊːlɑx
amusigulxu	ɑmʃʊːlɑx
amusxixü	ɑmsxiːx
amurǰixu	ɑmɑrʤɪx
amurǰigulxu	ɑmɑrʤʊːlɑx
amsaixu	ɑmsɪːx
amsaxu	ɑmsɑx
amsaganaxu	ɑmsɡɑnɑx
amsalǰaxu	ɑmsɑlʤɪx
amtagdaxu	ɑmtɑɡdɑx
amtalaxu	ɑmtlɑx
amtasixu	ɑmtɑʃɪx
amtarxaxu	ɑmtɑrxɑx
amčuixu	ɑmʧɪːx
amǰixu	ɑmʤɪx
alabxixü	ɑlɑbxiːx
alabčaxu	ɑlɑbʧɪx
alaxu	ɑlɑx
alagabčilaxu	ɑlɡɑbʧlɑx
alagadaxu	ɑlɡɑdɑx
alaglaxu	ɑlɑɡlɑx
alagsaxu	ɑlɑɡsɑx
alagsixu	ɑlɑɡʃɪx
alagsigulxu	ɑlɑɡʃʊːlɑx
alagčilaxu	ɑlɑɡʧlɑx
alalduxu	ɑlɑldɑx
alasilaxu	ɑlʃlɑx
alasxixü	ɑlsxiːx
aladaxu	ɑldɑx
aliglaxu	ælɪɡlɑx
aliyalaxu	ælɪɑlɑx
aliyatuxu	ælɪɑtɑx
aliyaraxu	ælɪɑrɑx
aliyarxaxu	ælɪɑrxɑx
aluxadaxu	ɑlxdɑx
aluslaxu	ɑlslɑx
alusdaxu	ɑlsdɑx
albadaxu	ɑlɑbdɑx
alxaixu	ɑlxɪːx
alxaglaxu	ɑlxɑɡlɑx
alxixu	ælxɪx
alxilduxu	ælxɪldɑx
alxuxu	ɑlxɑx
alxumlaxu	ɑlxɑmlɑx
alxulaxu	ɑlxlɑx
algaudaxu	ɑlɡʊːdɑx
algasaxu	ɑlɡɑsɑx
algasagulxu	ɑlɡɑsʊːlɑx
algurlaxu	ɑlɡʊːrlɑx
algurdaxu	ɑlɡʊːrdɑx
almaituxu	ɑlmæːtɑx
almairaxu	ɑlmæːrɑx
almalaxu	ɑlɑmlɑx
almaraxu	ɑlɑmrɑx
altalaxu	ɑltlɑx
altadaxu	ɑltdɑx
aldaxu	ɑldɑx
aldagulxu	ɑldʊːlɑx
aldaguraxu	ɑldʊːrɑx
aldagdaxu	ɑldɑɡdɑx
aldalaxu	ɑldlɑx
aldaraxu	ɑldrɑx
aldaragaxu	ɑldrɑːx~ɑldɑrɡɑx
aldarsixu	ɑldɑrʃɪx
aldarsigulxu	ɑldɑrʃʊːlɑx
alčaixu	ɑlʧɪːx
alčabalǰaxu	ɑlʧbɑlʤɪx
alčabčixu	ɑlʧɪbʧɪx
alčaganaxu	ɑlʧɡɑnɑx
alčamlaxu	ɑlʧɪmlɑx
alčalǰaxu	ɑlʧɪlʤɪx
alǰaxu	ɑlʤɪx
alǰaguraxu	ɑlʤʊːrɑx
alǰiyaxu	ɑlʤɑːx
alǰiyaraxu	ɑlʤɑːrɑx
asaxu	ɑsɑx
asagaxu	ɑsɑːx
asaguxu	ɑsʊːx
asagtuxu	ɑsɑɡtɑx
asamadaxu	ɑsɑmdɑx
asamaraxu	ɑsɑmrɑx
asaraxu	ɑsrɑx
asaramǰilaxu	ɑsrɑmʤlɑx
asarlaxu	ɑsɑrlɑx
asiglaxu	ɑʃɪɡlɑx
asiglagulxu	ɑʃɪɡlʊːlɑx
asilaxu	ɑʃlɑx
asurudaxu	ɑsɑrdɑx
asburdaxu	ɑsbɑrdɑx
asxaxu	ɑsɡɑx
asxaraxu	ɑsɡɑrɑx
asxaragulxu	ɑsɡɑrʊːlɑx
asxixu	ɑʃɡɪx
aslaxu	ɑslɑx
atabčilaxu	ɑtɑbʧlɑx
atagarxaxu	ɑtɑːrxɑx
atalaxu	ɑtlɑx
atalgadaxu	ɑtlɑɡdɑx
ataraxu	ɑtrɑx
atarlaxu	ɑtɑrlɑx
atarsixu	ɑtɑrʃɪx
atarsigulxu	ɑtɑrʃʊːlɑx
atarǰixu	ɑtɑrʤɪx
atuixu	ætɪːx
atubalǰaxu	ætbɑlʤɪx
atuganaxu	ætɡɑnɑx
atulčaxu	ɑtɑlʧɪx
atulǰaxu	ætɪlʤɪx
aturixu	ætrɑx
aturigulxu	ætrʊːlɑx
aturiyatuxu	ætrɑːtɑx
adairlaxu	ɑdæːrlɑx
adaŋgalaxu	ɑdɑŋɡɑlɑx
adaxu	ɑdɑx
adagarlaxu	ɑdɑːrlɑx
adaglaxu	ɑdɑɡlɑx
adamnaxu	ɑdɑmnɑx
adalaxu	ɑdlɑx
adalisixu	ædɪlʃɪx
adalisiyaxu	ædɪlʃɑːx
adalidxaxu	ædɪltɡɑx
adalidxu	ædɪltɑx
adarautuxu	ɑdrʊːtɑx
adaraxu	ɑdrɑx
adaramalaxu	ɑdɑrmɑːlɑx
adarlaxu	ɑdɑːrlɑx
adarlaxu	ɑdɑrlɑx
adislaxu	ædɪslɑx
adistidlaxu	ædɪstɪdlɑx
adugulaxu	ɑdʊːlɑx
aduguǰixu	ɑdʊːʤɪx
adxaglaxu	ɑtɡɑɡlɑx
adxuxu	ɑtɡɑx
adxulaxu	ɑtɡɑlɑx
adxuraxu	ɑtɡɑrɑx
adgaxu	ɑdɡɑx
ačalaxu	ɑʧlɑx
ačadaxu	ɑʧdɑx
ačixu	ɑʧɪx
ačilaxu	ɑʧlɑx
ačiyalaxu	ɑʧɑːlɑx
ačiraxu	ɑʧrɑx~æʧrɑx
ačuglaxu	ɑʧɪɡlɑx
aǰanaxu	ɑʤnɑx
aǰadlaxu	ɑʤɪdlɑx
aǰixu	ɑʤɪx
aǰiglaxu	ɑʤɪɡlɑx
aǰillaxu	ɑʤɪllɑx
aǰiyaraxu	ɑʤɑːrɑx
aǰiraxu	ɑʤrɑx
aǰirxu	ɑʤrɑx
aǰirgalaxu	ɑʤrɑɡlɑx
ayansixu	ɑjɪnʃɪx
ayagalaxu	ɑjɡɑlɑx
ayagüičexü	ɑjɡuiʧix
ayagüirxexü	ɑjɡuirxəx
ayaglaxu	ɑjɪɡlɑx
ayalaxu	ɑjlɑx
ayalxu	ɑjlɑx
ayalgulaxu	ɑjɪlɡʊːlɑx
ayaslaxu	ɑjslɑx
ayasdaxu	ɑjsdɑx
ayadaxu	ɑjdɑx
ayadxu	ɑjdɑx
ayarlaxu	ɑjɑːrlɑx
ayuulaxu	ɑjʊːlɑx
ayuŋgalaxu	ɑjɪŋɡɑlɑx
ayuxu	æːx
ayulgaxu	æːlɡɑx
araŋgalaxu	ɑrɑŋɡɑlɑx
araŋgatuxu	ɑrɑŋɡɑtɑx
aragalaxu	ɑrɑːlɑx
aragilaxu	ærɪɡlɑx
aralsixu	ɑrɑlʃɪx
araldaxu	ɑrɑldɑx
aralǰixu	ærɪlʤɪx
aralǰiyalaxu	ærɪlʤɑːlɑx
arasulaxu	ɑrslɑx
aradčilaxu	ɑrdʧɪlɑx
aračaxu	ɑrʧɪx
aračilaxu	ɑrʧlɑx
arixidaxu	ærxdɑx
arigulaxu	ærɪʊlɑx
arigudxaxu	ærɪʊtɡɑx
arigudxu	ærɪʊtɑx
arilxu	ærlɑx
arilgaxu	ærɪlɡɑx
aruglaxu	ɑrɑɡlɑx
arulaxu	ɑrlɑx
arbaixu	ɑrbɪːx
arbaganaxu	ɑrɑbɡɑnɑx
arbagčixu	ɑrbɑɡʧɪx
arbalǰaxu	ɑrbɑlʤɪx
arbilaxu	ærɪblɑx
arbidaxu	ærɪbdɑx
arbidxaxu	ærɪbtɡɑx
arbidxu	ærɪbtɑx
arbiǰixu	ærɪbʤɪx
arbiǰigulxu	ærɪbʤʊːlɑx
arxaixu	ɑrxæːx
arxaglaxu	ɑrxɑɡlɑx
arxiraxu	ærxrɑx
argausxu	ɑrɡʊːsɑx
argaudxu	ɑrɡʊːtɑx
argaxu	ɑrɡɑx
argamǰixu	ɑrɡɑmʤɪx
argamǰiyalaxu	ɑrɡɑmʤɑːlɑx
argalaxu	ɑrɡɑlɑx
argadaxu	ɑrɡɑdɑx
argačaxu	ɑrɡɑʧɑːx
argixu	ærɡɪx
argiyatuxu	ærɡɪɑtɑx
armaxu	ɑrmɑx
arsaixu	ɑrsɪːx
artuxu	ɑrtɑx
ardagsixu	ɑrdɑɡʃɪx
arčiixu	ɑrʧɪːx
arčixu	ɑrʧɪx~ærʧɪx
arǰaixu	ɑrʤɪːx
arǰailgaxu	ɑrʤɪːlɡɑx
arǰaganaxu	ɑrʤɡɑnɑx
arǰagxixü	ɑrʤɪɡxiːx
arǰalǰaxu	ɑrʤɪlʤɪx
arǰasxixü	ɑrʤɪsxiːx
arǰiixu	ɑrʤɪːx
eixü	iːx
eiglexü	iːɡləx
eigexü	iːɡəx
eilxü	iːləx
eisilexü	iːʃləx
enegsixü	ənəɡʃix
enelxü	ənləx
enerixü	ənrəx
endexü	əndəx
endegdexü	əndəɡdəx
endegülxü	ənduːləx
endegürexü	ənduːrəx
eŋnexü	əɡnəx
eŋnegülxü	əɡnuːləx
eŋxeǰixü	əŋxʤix
eŋxüreilexü	əŋxreːləx
eŋxüreglexü	əŋxrəɡləx
eŋgelǰegürdexü	əŋɡəlʤuːrdəx
eŋgesxedexü	əŋɡəsəɡdəx
eŋgedexü	əŋɡədəx
eŋgerlexü	əŋɡərləx
eŋgürxü	əŋɡərəx
eŋselxü	əŋsləx
eŋselgexü	əŋsəlɡəx
ebeilexü	əbiːləx
ebesülexü	obslox
ebesütüxü	obstox
ebedxü	obdox
ebedčilexü	obʧlox
eberexü	əbrəx
eberegexü	əbrəːx
eberlexü	əbərləx
ebersixü	əbərʃix
ebersiyexü	əbərʃəːx
ebertüxü	əbərtəx
eberdexü	əbərdəx
eberǰixü	əbərʤix
ebügečilexü	oboɡʧlox
ebügeǰixü	oboɡʤix
ebügerexü	oboɡrox
ebügerxexü	obɡorxox
ebülsixü	obolʃix
ebülǰixü	obolʤix
ebülǰigülxü	obolʤuːləx
ebülǰiyelexü	obolʤoːlox
ebüdüglexü	obdoɡlox
ebüdügčexü	obdoɡʧix
ebüčeldüxü	obʧildox
ebürlexü	oborlox
ebürtülexü	obortlox
ebxexü	əbxəx
ebxerexü	əbxrəx
eblexü	əbləx
eblegexü	əbləːx
eblegülxü	əbluːləx
ebleldüxü	əbləldəx
eblerexü	əblərəx
ebleregülxü	əbləruːləx
eblereldüxü	əblərəldəx
ebsexü	əbsəx
ebsegülxü	əbsuːləx
ebseldüxü	əbsəldəx
ebseldügülxü	əbsəlduːləx
ebsixü	əbʃix
ebsiyexü	əbʃəːx
ebsiyelgexü	əbʃəːlɡəx
ebdexü	əbdəx
ebdelexü	əbdləx
ebdečixü	əbdʧix
ebderexü	əbdrəx
ebderelčexü	əbdrəlʧix
ebčexü	əbʧix
exegürexü	əxuːrəx
exelexü	əxləx
exečilexü	əxʧləx
exilexü	əxləx
egseixü	əɡsiːx
egsixü	əɡʃix
egsigexü	əɡʃəːx
egdegüčexü	əɡduːʧix
egdegürexü	əɡduːrəx
egčelexü	əɡʧləx
egčedexü	əɡʧdəx
egčerexü	əɡʧrəx
egenexü	əːnəx
egenegsixü	əːnəɡʃix
egebürdexü	əːbərdəx
egexü	əɡəx
egexü	əːx
egeglexü	əːɡləx
egegexü	əːx
egegerxü	əːrəx
egegülxü	əɡuːləx
egemüglexü	əːməɡləx
egemdexü	əɡəmdəx
egelilexü	əːlləx
egeldürxü	əɡəldrəx
egeldürgelexü	əɡəldrəɡləx
egelǰixü	əːlʤix
egelǰilexü	əːlʤləx
egesiglexü	əɡʃiɡləx
egesigǰixü	əɡʃiɡʤix
egeteixü	əːtiːx
egetüüslexü	əːtuːsləx
egedeirexü	əːdeːrəx
egedexü	əːdəx
egedegülxü	əːduːləx
egedemtüxü	əːdəmtəx
egederexü	əːdrəx
egedüürexü	əːduːrəx
egeǰiglexü	əɡʤiɡləx
egereüdexü	əːruːdəx
egerexü	əːrəx
egirexü	əɡrəx
egüxü	uːx
egülesixü	uːlʃix
egületüxü	uːltəx
egülgertüxü	uːlɡərtəx
egüsbürilexü	uːsbərləx
egüsxexü	uːsɡəx
egüsxü	uːsəx
egüdelexü	uːdləx
egüdxexü	uːtɡəx
egüdxü	uːdəx
egüriǰixü	uːrʤix
egürxü	uːrəx
egürgelexü	uːrəɡləx
egürlexü	uːrləx
egürtüxü	uːrtəx
emegellexü	əməːlləx
emegeldexü	əməːldəx
emegerexü	əməɡrəx
emiyexü	əməːx
emünesilexü	omonʃlox
emüsxexü	omsɡox
emüsxü	omsox
emnexü	əmnəx
emnegülxü	əmnuːləx
emnigsixü	əmnəɡʃix
emnigrexü	əmnəɡrəx
embürixü	omrox
emxeridxü	əmxərdəx
emxilexü	əmxələx
emxidxexü	əmxətɡəx
emxirexü	əmxərəx
emxüxü	umxəx~uŋxəx
emxülexü	umxələx~uŋxləx
emgenixü	əməɡnəx
emgeglexü	əmɡəɡləx
emseixü	əmsiːx
emseglexü	əmsəɡləx
emsegenexü	əmsəɡnəx
emselǰexü	əmsəlʤix
emsiixü	əmʃiːx
emteixü	əmtiːx
emtelxü	əmtləx
emterexü	əmtrəx
emčilexü	əmʧləx
emčilegülxü	əmʧluːləx
emǰeglexü	əmʤiɡləx
emǰixü	əmʤix
emǰiyerilexü	əmʤəːrləx
eleirexü	əliːrəx
eleŋxeitüxü	ələŋxeːtəx
elexü	ələx
eleglexü	ələɡləx
elegdexü	ələɡdəx
elegexü	ələːx
elesütüxü	əlstəx
elixü	ələx
eligelexü	ələɡləx
eligesexü	ələɡsəx
eligeseglexü	ələɡsəɡləx
eligesixü	ələɡʃix
eligesiyexü	ələɡʃəːx
eligetüxü	ələɡtəx
eligedexü	ələɡdəx
eligerexü	ələɡrəx
eliyetüxü	ələːtəx
elüxü	ələx
elbexü	əlbəx
elbegsixü	əlbəɡʃix
elbegǰixü	əlbəɡʤix
elberixü	ələbrəx
elxegdexü	əlxəɡdəx
elgüxü	olɡox
elgüčexü	oloɡʧix
elmerxü	ələmrəx
elsexü	əlsəx
elseglexü	əlsəɡləx
eltelxü	əltləx
elterexü	əltrəx
eltülexü	əltləx
eldeŋnexü	əldəɡnəx
eldeblexü	əldəbləx
eldebčilexü	əldəbʧləx
eldexü	əldəx
esenixü	əsnəx
esexü	əsəx
esergüčexü	əsərɡuːʧix
esergüčeldüxü	əsərɡuːʧildəx
esergüčeldügülxü	əsərɡuːʧilduːləx
esilexü	iʃləx
esitüxü	iʃtəx
esxexü	əsɡəx
eteixü	ətiːx
etexü	ətəx
etegedlexü	ətɡəːdləx
etelǰexü	ətəlʤix
eterixü	ətrəx
eterigülxü	ətruːləx
ed'lexü	ədləx
ed'legülxü	ədluːləx
ed'sigülxü	ədʃuːləx
edegexü	ədɡəx
edegegexü	ədɡəːx
edegerexü	ədəɡrəx
edegeregülxü	ədəɡruːləx
ederexü	ədrəx
edüxü	odox
edügülbürilexü	odoːlbərləx
edürlexü	odorlox
ečeŋxeirexü	əʧiŋxeːrəx
ečeŋgitüxü	əʧiŋɡətəx
ečexü	əʧix
ečixü	əʧix
ečigedexü	əʧiɡdəx
ečigečilexü	əʧiɡʧləx
ečülxü	əʧləx
ečülgexü	əʧilɡəx
ečüslexü	əʧisləx
ečüdlexü	əʧidləx
eǰeŋnexü	əʤiɡnəx
eǰegüičilexü	əʤɡuiʧləx
eǰegüirexü	əʤɡuirəx
eǰemsixü	əʤimʃix
eǰemdexü	əʤimdəx
eǰelexü	əʤləx
eǰesixü	əʤʃix
eǰerxexü	əʤirxəx
eǰerxeglexü	əʤirxəɡləx
eyelexü	əjləx
eyesexü	əjsəx
eyedexü	əjdəx
eyedegülxü	əjduːləx
eyersixü	əjirʃix
eyertüxü	əjirtəx
ereixü	əriːx
ereilgexü	əriːlɡəx
ereüdexü	əruːdəx
ereŋčexü	ərəŋʧix
erexeibčilexü	ərxiːbʧləx
erexexü	ərxəx
erexegexü	ərxəːx
erexü	ərəx
eregelexü	ərəːləx
eregelǰexü	ərɡəlʤix
eregülexü	əruːləx
eregülǰixü	əruːlʤix
eregüdexü	əruːdəx
eremelǰexü	ərməlʤix
eremečexü	ərəmʧix
eremsixü	ərəmʃix
erelxexü	ərəlxəx
ereslexü	ərsləx
eresdexü	ərsdəx
erečilexü	ərʧləx
erixelexü	ərxləx
erixü	ərəx
erilxilexü	ərəlxiːləx
eričixü	ərʧix
eriyentüxü	ərəːntəx
eriyelexü	ərəːləx
eriyelǰexü	ərəːlʤix
eriyelǰilexü	ərəːlʤləx
eriyečixü	ərəːʧix
erüxelexü	orxlox
erüxü	ərəx
erbeixü	ərbiːx
erbeilexü	ərbeːləx
erbegenexü	ərbəɡnəx
erbegelǰilexü	ərbəːlʤləx
erbelǰexü	ərbəlʤix
erbesxixü	ərbəsxiːx
erxeglexü	ərxəɡləx
erxemsüglexü	ərxəmsəɡləx
erxelexü	ərxləx
erxelegülxü	ərxluːləx
erxesixü	ərxʃix
erxesiyexü	ərxʃəːx
erxibčilexü	ərxəbʧləx
erximlexü	ərxəmləx
erximsüglexü	ərxəmsəɡləx
erxilexü	ərxləx
erxirexü	ərxrəx
ergixü	ərɡəx
ergigülxü	ərɡuːləx
ergigüldexü	ərɡuːldəx
ergigütüxü	ərɡuːtəx
ergigüdexü	ərɡuːdəx
ergildüxü	ərɡəldəx
ergildügülxü	ərɡəlduːləx
ergidexü	ərəɡdəx
ergičexü	ərəɡʧix
ergičegülxü	ərəɡʧuːləx
ergüxü	orɡox
ergümǰilexü	orɡomʤlox
erliseǰixü	ərliːsʤix
erliseǰigülxü	ərliːsʤuːləx
erteixü	ərtiːx
ertegenexü	ərtəɡnəx
ertelexü	ərtləx
ertelǰexü	ərtəlʤix
ertedexü	ərtdəx
ertedxü	ərttəx
erdenilexü	ərdənləx
erdemlexü	ərdəmləx
erdüxü	ərdəx
erčeidxü	ərʧiːdəx
erčixü	ərʧix
erčigexü	ərʧəːx
erčimnexü	ərʧimnəx
erčimlexü	ərʧimləx
erčimǰixü	ərʧimʤix
erčimǰigülxü	ərʧimʤuːləx
erčilexü	ərʧləx
inaglaxu	ɪnɑɡlɑx
inagsilaxu	ɪnɑɡʃlɑx
inagsidaxu	ɪnɑɡʃdɑx
iniyexü	iniəx
iniyemsüglexü	iniəmsəɡləx
iniyelgexü	iniəlɡəx
inčagaxu	ɪnʧɡɑːx
inčagalaxu	ɪnʧɡɑːlɑx
inčaglaxu	ɪnʧɪɡlɑx
inǰagalaxu	ɪnʤɡɑlɑx
inǰilexü	inʤləx
iŋgarčaxu	ɪŋɡɑrʧɑːx
iŋgelexü	iŋɡələx
iŋgerexü	iŋɡərəx
iŋgixü	iŋɡəx~əŋɡəx
iŋdeüdexü	induːdəx
iŋdexü	iŋdəx
ibaganaxu	ɪbɡɑnɑx
ibexü	ibəx
ibegexü	ibəːx
ibegesülexü	ibəːsləx
ibelxü	ibləx
iberexü	ibrəx
ibilxü	ibləx
ibilgexü	ibəlɡəx
ibčudaxu	ɪbʧʊːdɑx
ibčudxu	ɪbʧʊːtɑx
ibčuraxu	ɪbʧʊːrɑx
ixerelexü	ixərləx
iguxu	jʊɡɑx
ig°čidxu	ɪɡʧtɑx
ig°čudxu	ɪɡʧtɑx
ig°čuraxu	ɪɡʧrɑx
imagatuxu	ɪmɑːtɑx~jɑmɑːtɑx
imagaǰixu	ɪmɑːʤɪx~jɑmɑːʤɪx
imerxü	imrəx
imnexü	imnəx
ilaxu	ɪlɑx
ilagaxu	ɪlɑːx
ilagarxaxu	ɪlɑːrxɑx
ilaguxu	ɪlɡʊːx
ilagdaxu	ɪlɑɡdɑx
ilarisixu	ɪlɑːrʃɪx
ileilexü	ileːləx
ileürdexü	iluːrdəx
ilegexü	ilɡəːx
ilegüdexü	iluːdəx
ilegüdxü	iluːtəx
ilegüčilexü	iluːʧləx
iledxexü	iltɡəx
ilečilexü	ilʧləx
ilerexü	ilrəx
ileregülxü	ilruːləx
ilerxeilexü	ilərxeːləx
ilixü	iləx
iligürdexü	iluːrdəx
iliyesülexü	iləːsləx
ilbaixu	ɪlbɪːx
ilbaganaxu	ɪlɑbɡɑnɑx
ilbalǰaxu	ɪlbɑlʤɪx
ilbesxixü	ilbəsxiːx
ilberixü	iləbrəx
ilbixü	ilbəx
ilbigürdexü	ilbuːrdəx
ilbulxu	ɪlɑblɑx
ilburaxu	ɪlɑbrɑx
ilgaburilaxu	ɪlɡɑbɑrlɑx
ilgaxu	ɪlɡɑx
ilgagdaxu	ɪlɡɑɡdɑx
ilgallaxu	ɪlɡɑllɑx
ilgaraxu	ɪlɡɑrɑx
ilgaragulxu	ɪlɡɑrʊːlɑx
ilgilexü	iləɡləx
ilgidexü	iləɡdəx
ilmagailaxu	ɪlɑmɡæːlɑx
ilmagalǰaxu	ɪlɑmɡɑlʤɪx
iltaixu	ɪltɪːx
iltalxu	ɪltlɑx
iltaraxu	ɪltrɑx
ilčaixu	ɪlʧɪːx
ilčiginexü	ilʧiɡnəx
ilǰalxu	ɪlʤlɑx
ilǰaraxu	ɪlʤrɑx
ilǰaragulxu	ɪlʤrʊːlɑx
ilǰirexü	ilʤrəx
ilǰiregülxü	ilʤruːləx
isegeirexü	isɡiːrəx~əsɡiːrəx
iselxü	isləx
isigelexü	iʃiɡləx
isilxü	iʃləx
isültüxü	isəltəx
isütüxü	istəx
isbelǰexü	isbəlʤix
isxexü	isɡəx
isxerxü	isəɡrəx
isxerdexü	isɡərdəx
isxü	isəx
isxülxü	oʃiɡlox
isxüčexü	oʃiɡʧix
islexü	isləx
itegexü	itɡəx
itegegülxü	itɡuːləx
itegemǰilexü	itɡəmʤləx
idamlaxu	ɪdɑmlɑx
idebxilexü	idəbxləx
idebxiǰixü	idəbxʤix
idexü	idəx
idegdexü	idəɡdəx
idegelexü	idəːləx
idegesixü	idəːʃix
idegerxexü	idəːrxəx
idegerlexü	idəːrləx
idegülxü	iduːləx
idelexü	idləx
idesilexü	idəʃləx
iderxexü	idərxəx
idersixü	idərʃix
idugalaxu	ʊdɡɑlɑx
idxaxu	ɪtɡɑx
idxamǰilaxu	ɪtɡɑmʤlɑx
ičeŋgürexü	iʧiŋɡuːrəx
ičexü	iʧix
ičegelexü	iʧəːləx
ičiŋgürexü	iʧiŋɡuːrəx
ičixü	iʧix
ičigexü	iʧəːx
ičigelexü	iʧɡəːləx
ičiridexü	iʧirdəx
iǰaganaxu	ɪʤɡɑnɑx
iǰamagtuxu	ɪʤmɑɡtɑx
iǰalxu	ɪʤlɑx
iǰarautuxu	ɪʤrʊːtɑx
iǰaraxu	ɪʤrɑx
iǰilisxü	iʤilsəx
iǰilidxü	iʤiltəx
iǰilsixü	iʤilʃix
iǰilsigülxü	iʤilʃuːləx
iǰiltüxü	iʤiltəx
iraixu	ɪrɪːx
iraxu	ɪrɑx
iragalaxu	ɪrɑːlɑx
iragatuxu	ɪrɑːtɑx
iraglaxu	ɪrɑɡlɑx
iralǰaxu	ɪrɑlʤɪx
iralǰilaxu	ɪrɑlʤlɑx
iralǰituxu	ɪrɑlʤtɑx
irexü	irəx
iregülxü	iruːləx
irogallaxu	jɔrɔːllɔx
iruwalaxu	jɔrlɔx
irögexü	joroːx
irbaixu	ɪrbɪːx
irbaganaxu	ɪrɑbɡɑnɑx
irbagčixu	ɪrbɑɡʧɪx
irbalǰaxu	ɪrbɑlʤɪx
irbasxixü	ɪrbɑsxiːx
irbiginexü	irbəɡnəx
irbilǰexü	irbəlʤix
irxirexü	irxrəx
irxü	irəx
irgaxu	ɪrɡɑx
irgagalaxu	ɪrɡɑːlɑx
irguxu	ɪrɡɑx~jʊrɡɑx
irmexü	irməx
irmeglexü	irməɡləx
irmegdexü	irməɡdəx
irmegüdxü	irmuːtəx
irlexü	irləx
irtaixu	ɪrtɪːx
irtailgaxu	ɪrtɪːlɡɑx
irtalǰaxu	ɪrtɑlʤɪx
irčiixü	irʧiːx
irčiginexü	irʧiɡnəx
irčilǰexü	irʧilʤix
irǰaixu	ɪrʤɪːx
irǰailgaxu	ɪrʤɪːlɡɑx
irǰabalǰaxu	ɪrʤbɑlʤɪx
irǰaganaxu	ɪrʤɡɑnɑx
irǰalǰaxu	ɪrʤɪlʤɪx
irǰasxixü	ɪrʤɪsxiːx
irǰiixü	irʤiːx
izidexü	iːsdəx~iːʣdəx
oixu	œːx
oilaxu	œːlɔx
oilagaxu	œːlɡɔx
oilxilaxu	œːlxiːləx
oilxu	œːlɔx
oilgaxu	œːlɡɔx
oisiyaxu	œːʃɔːx
oičixu	œːʧɪx
oiǰixu	œːʤɪx
oiǰigulxu	œːʤʊːlɑx
oiratuxu	œːrtɔx
oiradaxu	œːrdɔx
oiradxu	œːrtɔx
oodaxu	ɔːdɔx
oniixu	œnɪːx
oniilgaxu	œnɪːlɡɔx
onibalǰaxu	œnbɔlʤɪx
onibčixu	œnɪbʧɪx
onilaxu	œnlɔx
onilǰaxu	œnɪlʤɪx
onisogačaxu	œnsɔɡʧɪx
onisolaxu	œnslɔx
onoxu	ɔnɔx
onogaxu	ɔnɔːx
onogolaxu	ɔnɔːlɔx
onogoraxu	ɔnɔːrɔx
onogdaxu	ɔnɔɡdɔx
onolduxu	ɔnɔldɔx
onosilaxu	ɔnɔʃlɔx
ondoixu	ɔndɔɪx
ondoolaxu	ɔndɔːlɔx
ondoosixu	ɔndɔːʃɪx
ondoorxaxu	ɔndɔːrxɔx
ondogalaxu	ɔndɡɔlɔx
ondogčixu	ɔndɔɡʧɪx
ondolǰaxu	ɔndɔlʤɪx
ondočixu	ɔndʧɪx
ondoroxu	ɔndrɔx
ondorxu	ɔndrɔx
ončalaxu	ɔnʧlɔx
ončaraxu	ɔnʧrɔx
ončidaxu	ɔnʧdɔx
ončiraxu	ɔnʧrɔx
ončirxu	ɔnʧrɔx
ončogoilaxu	ɔnʧɡœːlɔx
ončogoidaxu	ɔnʧɡœːdɔx
ončogoiraxu	ɔnʧɡœːrɔx
oŋnoixu	ɔɡnɔɪx
oŋxoixu	ɔŋxɔɪx
oŋxolixu	œŋxlɔx
oŋxoldaxu	ɔŋxɔldɔx
oŋgilaxu	œŋɡɪlɔx
oŋgilxu	œŋɡɪlɔx
oŋgičixu	œŋɡɪʧɪx
oŋgiraxu	œŋɡɪrɔx
oŋgiragatuxu	œŋɡɪrɔːtɔx
oŋgiragadaxu	œŋɡɪrɔːdɔx
oŋgoixu	ɔŋɡɔɪx
oŋgoxu	ɔŋɡɔx
oŋgolaxu	ɔŋɡɔlɔx
oŋgolixu	œŋɡɔlɔx
oŋgolxu	ɔŋɡɔlɔx
oŋgolǰaxu	ɔŋɡɔlʤɪx
oŋgosxixü	ɔŋɡɔsxiːx
oŋgodxu	ɔŋɡɔdɔx
oŋgodčilaxu	ɔŋɡɔdʧɪlɔx
oŋgoraituxu	ɔŋɡɔrœːtɔx
oŋgordogaxu	ɔŋɡɔrdɔːx
oboixu	ɔbɔɪx
obogalaxu	ɔbɔːlɔx
obogaraxu	ɔbɔːrɔx
obogaralduxu	ɔbɔːrɔldɔx
obogonaxu	ɔbɡɔnɔx
obolǰaxu	ɔbɔlʤɪx
obosxixü	ɔbsxiːx
oborxilaxu	ɔbɔrxiːləx
oborxu	ɔbrɔx
oborlaxu	ɔbɔrlɔx
obordaxu	ɔbɔrdɔx
oborǰixu	ɔbɔrʤɪx
obxoixu	ɔbxɔɪx
obxogonaxu	ɔbxɡɔnɔx
obxolǰaxu	ɔbxɔlʤɪx
oblaxu	ɔblɔx
obǰagalaxu	ɔbʤɪɡlɔx
oxilaxu	œxlɔx
oxordaxu	ɔxɔrdɔx
ogixu	œɡɪx
ogigulxu	œɡɪʊlɑx
ogisxu	œɡsɔx
ogolidaxu	œːldɔx
ogosorlaxu	ɔːsɔrlɔx
ogotordaxu	ɔɡtɔrdɔx
ogodoixu	ɔːdɔɪx
ogodoŋnaxu	ɔːdɔɡnɔx
ogodoŋtoxu	ɔːdɔŋtɔx
ogodoŋdaxu	ɔːdɔŋdɔx
ogodoraxu	ɔːdrɔx
ogočixu	ɔːʧɪx
ogočilaxu	ɔːʧlɔx
ogorxu	ɔɡɔːrɔx
ogorčilaxu	ɔɡɔrʧlɔx
oggixu	œɡɪx
ogloraxu	ɔɡlɔrɔx
ogsixu	ɔɡʃɪx
ogsiguraxu	ɔɡʃʊːrɑx
ogsoixu	ɔɡsɔɪx
ogsogordaxu	ɔɡsɡɔrdɔx
ogsolǰaxu	ɔɡsɔlʤɪx
ogtolxu	ɔɡtlɔx
ogtočixu	ɔɡtʧɪx
ogdoixu	ɔɡdɔɪx
ogdoilgaxu	ɔɡdɔɪlɡɔx
ogdogordaxu	ɔɡdɡɔrdɔx
ogdogčixu	ɔɡdɔɡʧɪx
ogčomlaxu	ɔɡʧɪmlɔx
ogčolxu	ɔɡʧlɔx
ogčoraxu	ɔɡʧrɔx
ogǰomlaxu	ɔɡʤɪmlɔx
ogǰomdaxu	ɔɡʤɪmdɔx
omoixu	ɔmɔɪx
omoilgaxu	ɔmɔɪlɡɔx
omogonaxu	ɔmɡɔnɔx
omogoltoxu	ɔmɡɔltɔx
omogordaxu	ɔmɡɔrdɔx
omoglaŋtuxu	ɔmɔɡlɔŋtɔx
omoglaŋdaxu	ɔmɔɡlɔŋdɔx
omoglaxu	ɔmɔɡlɔx
omogsixu	ɔmɔɡʃɪx
omogdaxu	ɔmɔɡdɔx
omolǰaxu	ɔmɔlʤɪx
omorxaxu	ɔmɔrxɔx
omorxaglaxu	ɔmɔrxɔɡlɔx
omtogailaxu	ɔmtɡœːlɔx
omtogairaxu	ɔmtɡœːrɔx
olasiraxu	ɔlʃrɔx
oladaxu	ɔldɔx
oladxu	ɔltɔx
oliixu	œlɪːx
olibalǰaxu	œlbɔlʤɪx
olixu	œlɪx
oloirtoxu	ɔlœːrtɔx
oloŋnaxu	ɔlɔɡnɔx
ologailaxu	ɔlɡœːlɔx
ologaisxu	ɔlɡœːsɔx
ologoidxu	ɔlɡœːdɔx
olbitoxu	œlɪbtɔx
olxixu	œlxɪx
olxu	ɔlɔx
olgoxu	ɔlɡɔx
oltoxu	ɔltɔx
oldaxu	ɔldɔx
oldoiraxu	ɔldœːrɔx
oldogurilaxu	ɔldʊːrlɑx
olǰalaxu	ɔlʤlɔx
olǰarxaxu	ɔlʤɪrxɔx
osogoxu	ɔsɡɔx
osoldaxu	ɔsɔldɔx
osxordoxu	ɔsɡɔrtɔx
osxu	ɔsɔx
otačilaxu	ɔtɔʧlɔx
otoxu	ɔtɔx
otogalaxu	ɔtɡɔlɔx
otoglaxu	ɔtɔɡlɔx
otolaxu	ɔtlɔx
otorlaxu	ɔtɔrlɔx
otorčilaxu	ɔtɔrʧlɔx
odoixu	ɔdɔɪx
odoxičilaxu	ɔdɔːxʧɪlɔx
odolaxu	ɔdlɔx
odotoxu	ɔdtɔx
odxolaxu	ɔtɡɔlɔx
odxu	ɔdɔx
očixu	ɔʧɪx
očoixu	ɔʧɪːx
očoglaxu	ɔʧɪɡlɔx
oǰoxu	ɔʤɪx
oyoxu	ɔjɪx
oyogarlaxu	ɔjɔːrlɔx
oyoglaxu	ɔjɪɡlɔx
orilaxu	œrlɔx
oriyaŋgituxu	ɔrɔːŋɡɪtɔx
oriyaxu	ɔrɔːx
oriyalduxu	ɔrɔːldɔx
oriyadasulaxu	ɔrɔːdɔslɔx
oriyačalduxu	ɔrɔːʧɪldɔx
oroilaxu	ɔrœːlɔx
oroitaxu	ɔrœːtɔx
oroitoxu	ɔrœːtɔx
oronsixu	ɔrɔnʃɪx
orončoglaxu	ɔrɔnʧɪɡlɔx
oronǰixu	ɔrɔnʤɪx
oroŋnaxu	ɔrɔɡnɔx
oroxu	ɔrɔx
orogalaxu	ɔrɔːlɔx
orogulxu	ɔrʊːlɑx
oromlaxu	ɔrɔmlɔx
oromdaxu	ɔrɔmdɔx
orolaxu	ɔrlɔx
orolagulxu	ɔrlʊːlɑx
orolduxu	ɔrɔldɔx
orolčaxu	ɔrɔlʧɪx
orosixu	ɔrʃɪx
orosigulxu	ɔrʃʊːlɑx
orosčilaxu	ɔrɔsʧlɔx
orodosolaxu	ɔrdɔslɔx
orboixu	ɔrbɔɪx
orbogonaxu	ɔrɔbɡɔnɔx
orbolǰaxu	ɔrbɔlʤɪx
orxixu	œrxɪx
orxigdaxu	œrxɪɡdɔx
orxigdagulxu	œrxɪɡdʊːlɑx
orximǰilaxu	œrxɪmʤlɔx
orxilaxu	œrxlɔx
orxičaxu	œrxʧɪx
orxiraxu	œrxrɔx
orxoixu	ɔrxɔɪx
orgixu	œrɡɪx
orgigaxu	œrɡɪɔx
orgilxu	œrɡɪlɔx
orgiyatuxu	œrɡɪɔtɔx
orgoxu	ɔrɡɔx
orsoixu	ɔrsɔɪx
orsolǰaxu	ɔrsɔlʤɪx
orčiixu	ɔrʧɪːx
orčixu	ɔrʧɪx
orčigulxu	ɔrʧʊːlɑx
uigurlaxu	ʊɪɡɑrlɑx
uimuxu	ʊɪmɑx
uimuraxu	ʊɪmrɑx
uilaŋnaxu	ʊɪlɑɡnɑx
uilaŋxaituxu	ʊɪlɑŋxæːtɑx
uilaŋdaxu	ʊɪlɑŋdɑx
uilaxu	ʊɪlɑx
uilaganaxu	ʊɪlɡɑnɑx
uillaxu	ʊɪllɑx
uitadaxu	ʊɪtdɑx
uitadxu	ʊɪttɑx
uidxarlaxu	ʊɪtɡɑrlɑx
uidxu	ʊɪdɑx
uunaxu	ʊːnɑx
uubailaxu	ʊːbæːlɑx
uuxailaxu	ʊːxæːlɑx
uuxirxu	ʊɪxrɑx
uuguxu	ʊːx
uugulgaxu	ʊːlɡɑx
uulixailaxu	ʊːlxæːlɑx
uulixaituxu	ʊːlxæːtɑx
uulxu	ʊːlɑx
uulgamčilaxu	ʊːlɡɑmʧlɑx
uulgalaxu	ʊːlɡɑlɑx
uulgarlaxu	ʊːlɡɑrlɑx
unaxu	ʊnɑx
unagaxu	ʊnɡɑx~ʊnɡɑːx
unagalaxu	ʊnɡɑlɑx
uniyartuxu	ʊnɪɑrtɑx
unuxu	ʊnɑx
unugasiraxu	ʊnɑːʃrɑx
unugaǰixu	ʊnɑːʤɪx
untaxu	ʊntɑx
untagulxu	ʊntʊːlɑx
untaraxu	ʊntrɑx
untaragaxu	ʊntrɑːx
untugučaxu	ʊntʊːʧɪx
untuguraxu	ʊntʊːrɑx
untugurxaxu	ʊntʊːrxɑx
undagasxu	ʊndɑːsɑx
undalaxu	ʊndlɑx
undurxu	ʊndrɑx
unǰiixu	ʊnʤɪːx
unǰixu	ʊnʤɪx
unǰiginaxu	ʊnʤɪɡnɑx
unǰigirdaxu	ʊnʤɡɪrdɑx
unǰigudaxu	ʊnʤʊːdɑx
unǰiguraxu	ʊnʤʊːrɑx
unǰilduxu	ʊnʤɪldɑx
unǰilǰaxu	ʊnʤɪlʤɪx
unǰiyaraxu	ʊnʤɑːrɑx
unǰiraxu	ʊnʤrɑx
uŋxilaxu	ʊŋxʲlɑx
uŋxuixu	ʊŋxɪːx
uŋgasxu	ʊŋɡɑsɑx
uŋgarillaxu	ʊŋɡɑrɪllɑx
uŋguxu	ʊŋɡɑx
uŋgulixu	ʊŋɡɑlɪx
uŋguldaxu	ʊŋɡɑldɑx
uŋgusxaxu	ʊŋɡɑsɡɑx
uŋgusxu	ʊŋɡɑsɑx
uŋgudxu	ʊŋɡɑtɑx
uŋsaixu	ʊŋsɪːx
uŋsixu	ʊŋʃɪx
ubailaxu	ʊbæːlɑx
ubadislaxu	ʏbdɑslɑx
ubuxu	ʊbɑx
uxaburilaxu	ʊxbɑrlɑx
uxaxu	ʊxɑx
uxagalaxu	ʊxɑːlɑx
uxagaraxu	ʊxɑːrɑx
uxagaragulxu	ʊxɑːrʊːlɑx
uxagarxaxu	ʊxɑːrxɑx
uxagulxu	ʊxʊːlɑx
uxagdaxunčilaxu	ʊxɑɡdxʊːnʧlɑx
uxamsaraxu	ʊxɑmsrɑx
uxamsarlaxu	ʊxɑmsɑrlɑx
uxilaxu	ʊɪlɑx
uxiyaxu	ʊɡɑːx
uxuixu	ʊxɪːx
uxunasaxu	ʊxɑnsɑx
uxunatuxu	ʊxɑntɑx
uxuxu	ʊxɑx
uxumidaxu	ʊxɑmdɑx
uxusxixü	ʊxɑsxiːx
uxučilaxu	ʊxʧlɑx
uxurixu	ʊxrɪx
uxurigulxu	ʊxrɪʊlɑx
uxurisxixü	ʊxrɪsxiːx
ugaxu	ʊɡɑːx
ugalǰalaxu	ʊɡɑlʤlɑx
ugalǰaraxu	ʊɡɑlʤrɑx
uguxilaxu	ʊɪxlɑx
uguxu	ʊɡɑx
ugugixu	ʊːɡɪx
ugutalaxu	ʊːtlɑx
ugučalaxu	ʊːʧlɑx
ugurailaxu	ʊɡræːlɑx
ugurdaxu	ʊːrdɑx
uglaxu	ʊɡlɑx
ugsaraxu	ʊɡsrɑx
ugsugalaxu	ʊɡsɑːlɑx
ugtuxu	ʊɡtɑx
ugčaraxu	ʊɡʧrɑx
ugčaragulxu	ʊɡʧrʊːlɑx
ugǰačixu	ʊɡʤʧɪx
ugǰaraxu	ʊɡʤrɑx
ugǰixu	ʊɡʤɪx
umaixu	ʊmɪːx
umailgaxu	ʊmɪːlɡɑx
umaganaxu	ʊmɡɑnɑx
umalǰaxu	ʊmɑlʤɪx
umasilaxu	ʊmʃlɑx
umasxixü	ʊmsxiːx
umaraxu	ʊmrɑx
umartaxu	ʊmɑrtɑx
umbaixu	ʊmbɪːx
umbaxu	ʊmbɑx
umlaxu	ʊmlɑx
umdagasxu	ʊndɑːsɑx
umdalaxu	ʊndlɑx
ulaixu	ʊlæːx
ulailgaxu	ʊlæːlɡɑx
ulaisxaxu	ʊlæːsɡɑx
ulaisxu	ʊlæːsɑx
ulaidxaxu	ʊlæːtɡɑx
ulaidxu	ʊlæːtɑx
ulairaxu	ʊlæːrɑx
ulaŋgasxu	ʊlɑŋɡɑsɑx
ulabalǰaxu	ʊlbɑlʤɪx
ulabiixu	ʊlbɪːx
ulagalaxu	ʊlɑːlɑx
ulagadaxu	ʊlɑːdɑx
ulagačilaxu	ʊlɑːʧlɑx
ulamlaxu	ʊlɑmlɑx
ulamǰilaxu	ʊlɑmʤlɑx
ulalaxu	ʊllɑx
ulalǰaxu	ʊlɑlʤɪx
ulasxixü	ʊlsxiːx
uladaxu	ʊldɑx
ularixu	ʊlʲrɑx
ularigulxu	ʊlʲrʊːlɑx
ulixu	ʊlɪx
uliglaxu	ʊlɪɡlɑx
uligsixu	ʊlɪɡʃɪx
ulbarixu	ʊlɑbrɪx
ulbuixu	ʊlbɪːx
ulbuganaxu	ʊlɑbɡɑnɑx
ulbulǰaxu	ʊlbɑlʤɪx
ulburaxu	ʊlɑbrɑx
ulxuixu	ʊlxɪːx
ulxuganaxu	ʊlxɡɑnɑx
ulxulǰaxu	ʊlxɑlʤɪx
ulčaixu	ʊlʧɪːx
ulčaganaxu	ʊlʧɡɑnɑx
ulčalǰaxu	ʊlʧɪlʤɪx
ulǰiixu	ʊlʤɪːx
ulǰixu	ʊlʤɪx
usadxaxu	ʊstɡɑx
usadxu	ʊstɑx
usuŋgituxu	ʊsɑŋɡɪtɑx
usulaxu	ʊslɑx
usutuxu	ʊstɑx
usutö'rögčiǰixü	ʊstoroɡʧʤɪx
usuǰixu	ʊsʤɪx
usuǰigulxu	ʊsʤʊːlɑx
utasudaxu	ʊtɑsdɑx
utuxu	ʊtɑx
utugasixu	ʊtɑːʃɪx
utugatuxu	ʊtɑːtɑx
utugadaxu	ʊtɑːdɑx
udaxu	ʊdɑx
udagaxu	ʊdɑːx
udagasiraxu	ʊdɑːʃrɑx
udagasiragulxu	ʊdɑːʃrʊːlɑx
udagasxu	ʊdɑːsɑx
udagadxu	ʊdɑːtɑx
udasxixü	ʊdɑsxiːx
udarxu	ʊdrɑx
uduxu	ʊdɑx
udugalaxu	ʊdɡɑlɑx
udumlaxu	ʊdɑmlɑx
udumsixu	ʊdɑmʃɪx
uduridxu	ʊdɪrdɑx
udxačilaxu	ʊtɡɑʧlɑx
udxaǰixu	ʊtɡɑʤɪx
udxuxu	ʊtɡɑx
učagarlaxu	ʊʧɑːrlɑx
učagardaxu	ʊʧɑːrdɑx
učaraxu	ʊʧrɑx
učaralduxu	ʊʧrɑldɑx
učiglaxu	ʊʧɪɡlɑx
učirlaxu	ʊʧɪrlɑx
uǰixu	ʊʤɪx
uǰigraxu	ʊʤɪɡrɑx
uǰidlaxu	ʊʤɪdlɑx
uyaŋgalaxu	ʊjɪŋɡɑlɑx
uyaxu	ʊjɪx
uyagasixu	ʊjɑːʃɪx
uyagasiraxu	ʊjɑːʃrɑx
uyagdaxu	ʊjɪɡdɑx
uyalaxu	ʊjlɑx
uyalduxu	ʊjɪldɑx
uyaldugulxu	ʊjɪldʊːlɑx
uyadxaxu	ʊjtɡɑx
uyadxu	ʊjtɑx
uyaraxu	ʊjrɑx
uyaragulxu	ʊjrʊːlɑx
urailaxu	ʊræːlɑx
uraxalaxu	ʊrxlɑx
uraxadaxu	ʊrxdɑx
uraxu	ʊrɑx
uragdaxu	ʊrɑɡdɑx
uralaxu	ʊrlɑx
uraligǰixu	ʊrlɑɡʤɪx
uraligǰigulxu	ʊrlɑɡʤʊːlɑx
uračilaxu	ʊrʧlɑx
urixu	ʏrɪx
urisixu	ʏrʃɪx
uritaxu	ʏrtɑx~ʏrdɑx
uridčilaxu	ʏrdʧɪlɑx
uriyalaxu	ʊrɪɑlɑx
urugulsixu	ʊrʊːlʃɪx
uruguldaxu	ʊrʊːldɑx
urugudaxu	ʊrʊːdɑx
uruglaxu	ʊrɑɡlɑx
urugsaxu	ʊrɑɡsɑx
urugsilaxu	ʊrɑɡʃlɑx
urugsilagulxu	ʊrɑɡʃlʊːlɑx
urugsidaxu	ʊrɑɡʃdɑx
urugčaxu	ʊrɑɡʧɪx
urugčilaxu	ʊrɑɡʧlɑx
urumdaxu	ʊrɑmdɑx
urulduxu	ʊrɑldɑx
uruldugaxu	ʊrɑldɑːx
urusxaxu	ʊrsɡɑx
urusxu	ʊrsɑx
urbaixu	ʊrbɪːx
urbaxu	ʊrbɑx
urbaganaxu	ʊrɑbɡɑnɑx
urbagulxu	ʊrbʊːlɑx
urbalxilaxu	ʊrbɑlxiːləx
urbalǰaxu	ʊrbɑlʤɪx
urbasxixü	ʊrbɑsxiːx
urxaglaxu	ʊrxɑɡlɑx
urgalaxu	ʊrɡɑlɑx~ʊːrɡɑlɑx
urgixu	ʊrɡɪx
urguxu	ʊrɡɑx
urgugulxu	ʊrɡʊːlɑx
urmasixu	ʊrɑmʃɪx
urmasigulxu	ʊrɑmʃʊːlɑx
urmadaxu	ʊrɑmdɑx
ursiglaxu	ʊrʃɪɡlɑx
urtulaxu	ʊrtlɑx
urtulagulxu	ʊrtlʊːlɑx
urtudaxu	ʊrtdɑx
urtudxaxu	ʊrtɑtɡɑx
urtudxu	ʊrttɑx
urtučilaxu	ʊrtʧɪlɑx
ööblexü	oːblox
ööglexü	oːɡlox
önirǰixü	onorʤix
önöčidexü	onʧdox
önöčirexü	onʧrox
öndeixü	ondoix
öndeilgexü	ondoilɡox
öndegelexü	ondoɡlox
öndelǰexü	ondolʤix
öndesxixü	ondosxiːx
öndörlexü	ondorlox
öndörtöxü	ondortox
öndördexü	ondordox
öndörǰixü	ondorʤix
öndörǰigülxü	ondorʤuːləx
önčöglexü	onʧiɡlox
önčögdexü	onʧiɡdox
önǰixü	onʤix
önǰigexü	onʤoːx
öŋxörixü	oŋxrox
öŋxörigülxü	oŋxruːləx
öŋxöridexü	oŋxordox
öŋgeixü	oŋɡoix
öŋgelexü	oŋɡolox
öŋgelǰexü	oŋɡolʤix
öŋgesixü	oŋɡoʃix
öŋgesirexü	oŋɡoʃrox
öŋgesxixü	oŋɡosxiːx
öŋgereüdexü	oŋɡoruːdəx
öŋgerexü	oŋɡorox
öŋgeregexü	oŋɡoroːx
öŋgeregülxü	oŋɡoruːləx
öŋgörsixü	oŋɡorʃix
öŋgörtöxü	oŋɡortox
öŋgörǰixü	oŋɡorʤix
öberečilexü	oːrʧlox
öberümsexü	oːriːmsox
öbermičelexü	obormoʧlox
öbermičeǰixü	obormoʧʤix
öbermičeǰigülxü	obormoʧʤuːləx
öberčilexü	oborʧlox
öböixü	oboix~oːboix
öbölǰexü	obolʤix
öbörexü	obrox
öbörxü	obrox
öbörlexü	oborlox
öbxeixü	obxoix
öbxegenexü	obxoɡnox
öbxelǰexü	obxolʤix
öbčixü	obʧix
öxöidexü	oxoidox
öxögerdexü	oxoːrdox
ögxü	oɡox
öggögdexü	oɡoɡdox
ögsöxü	oɡsox
ögtexü	oɡtox
ögenteglexü	oːntoɡlox
ögexülexü	oːxlox
ögexüsixü	oːxʃix
ögexüǰixü	oːxʤix
ögeglexü	oːɡlox
ögelexü	oːlox
ögetüxü	oːtox
ögetügülxü	oːtuːləx
ögedelexü	oːdlox
ögečilexü	oːʧlox
ögerelxexü	oːrolxox
ögeretüxü	oːrtox
ögerečilexü	oːrʧlox
ögerečilegdexü	oːrʧloɡdox
ögirexü	oɡrox
ögiresixü	oɡorʃix
ögülexü	oɡuːləx~uɡuːləx
ömöixü	omoix
ömöilgexü	omoilɡox
ömöxirexü	omxorox
ömöglexü	omoɡlox
ömögenexü	omoɡnox
ömögelǰexü	omɡolʤix
ömögerexü	omoːrox
ömögerdexü	omɡordox
ömölxü	omlox
ömölǰexü	omolʤix
ömösxixü	omsxiːx
ömöčixü	omʧix
ömörexü	omrox
ömnögelexü	omnoːlox
ömbüülexü	ombuːləx
ömčilexü	omʧlox
ömčirxexü	omʧirxox
öliixü	oliːx
öliilgexü	oliːlɡox
ölibelǰexü	olbolʤix
ölixü	olix
öligerdexü	olɡordox
ölilǰexü	olilʤix
ölöŋgedxü	oloŋɡotox
ölöŋtöxü	oloŋtox
ölögdöxü	oloɡtox
ölögeidexü	olɡoidox
ölösxü	olsox
ölödexü	oldox
ölberxü	olobrox
ölmeidexü	olmoidox
öllexü	ollox
öldexü	oldox
ölčirsixü	olʧirʃix
ölǰeilexü	olʤiːləx
ösixü	oʃix
ösildüxü	oʃildox
ösiyelexü	oʃoːlox
ösiyerxexü	oʃoːrxox
ösireldüxü	oʃroldox
ösirxexü	oʃirxox
ösöglexü	osoɡlox
ösögeildexü	osɡoildox
ösögeidexü	osɡoidox
ösörxexü	osorxox
ösxexü	osɡox
ösxü	osox
öslexü	oslox
ötelxü	otlox
ötöixü	otoix
ötöbxixü	otobxiːx
ötöxü	otox
ötöglexü	otoɡlox
ötögsixü	otoɡʃix
ötögǰixü	otoɡʤix
ötölexü	otlox
ötötöxü	ottox
ötöčilexü	otʧilox
ödöxü	odox
ödögexü	odoːx
ödölexü	odlox
ödxedexü	otoɡdox
ödxedxü	otoɡtox
ödxerexü	otoɡrox
ödxeregülxü	otoɡruːləx
öčixü	oʧix
öčiglexü	oʧiɡlox
öčöixü	oʧiːx
öčölǰexü	oʧilʤix
öčügüdexü	oʧuːdəx
öčügüdxü	oʧuːtəx
öǰixü	oʤix
öǰigürxexü	oʤuːrxəx
öyöxeilexü	ojxoilox
öyöxelexü	ojixlox
öyögsixü	ojiɡʃix
öyögedexü	ojoːdox
örigütüxü	oroːtəx
örigüdexü	oroːdəx
örigüdxü	oroːtəx
örisöldüxü	orsoldox
örisxü	orsox
öritöxü	ortox
örönečilexü	oronʧlox
öröbelǰexü	orbolʤix
öröbxixü	orobxiːx
öröxü	orox
örögelexü	oroːlox
örögeldexü	oroːldox
örögesügeldexü	oroːsɡoldox
örögesülexü	oroːslox
örögesüdexü	oroːsdox
örömetüxü	oromtox
örömdexü	oromdox
örölexü	orlox
örölbidexü	orolbodox
örösiyeŋgüilexü	orʃoːŋɡuiləx
örösiyexü	orʃoːx
örösdexü	orsdox
örötexü	ortox
öröčelexü	orʧlox
örnixü	ornox
örnigülxü	ornuːləx
örböixü	orboix
örböilgexü	orboilɡox
örbögenexü	orboɡnox
örbögerdexü	orobɡordox
örbölǰexü	orbolʤix
örbösxixü	orbosxiːx
örgesülexü	orɡoslox
örgedexü	oroɡdox
örgedxexü	orɡotɡox
örgedxü	oroɡtox
örgeǰixü	oroɡʤix
örgeǰigülxü	oroɡʤuːləx
örgögelexü	orɡoːlox
örlögelexü	oɡloːlox
örteglexü	ortoɡlox
örtegelexü	ortoːlox
örtöxü	ortox
örtömsixü	ortomʃix
ördexü	ordox
üixü	uix
üimexü	uiməx
üimegülxü	uimuːləx
üimeldüxü	uiməldəx
üimeldügülxü	uiməlduːləx
üimelčexü	uiməlʧix
üimečexü	uimʧix
üiledbürilexü	uildbərləx
üiledbüriǰixü	uildbərʤix
üiledbüriǰigülxü	uildbərʤuːləx
üiledxexü	uiltɡəx
üiledxü	uildəx
üilečilexü	uilʧləx
üilǰexü	uilʤix
üisülexü	uisləx
üirexü	uirəx
üiregülxü	uiruːləx
üiremeglexü	uirməɡləx
üüxirexü	uːxrəx
üüxü	uːx
üüginexü	uːɡnəx
üügixü	uːɡəx
üürsexü	uːrsəx
ünenčilexü	unənʧləx
ünenčirxexü	unənʧirxəx
ünegečexü	unəɡʧix
ünegečilexü	unəɡʧləx
ünemlexü	unəmləx
ünemsixü	unəmʃix
ünemsigülxü	unəmʃuːləx
ünemsiyexü	unəmʃəːx
ünelexü	unləx
ünesülexü	unsləx
ünesütüxü	unstəx
ünesütügülxü	unstuːləx
ünesüdexü	unsdəx
üneteidexü	unteːdəx
ünerxexü	unərxəx
ünüsxü	unsəx
ünüslexü	unsləx
ünüsdexü	unsdəx
ünürlexü	unərləx
ünürlegülxü	unərluːləx
ünürtüxü	unərtəx
ündüsülexü	undəsləx
ündüsütenčilexü	undəstənʧləx
üŋgexü	uŋɡəx
üŋgečixü	uŋɡəʧix
üŋginexü	uŋɡənəx
üŋsüixü	uŋsiːx
üxenčedexü	uxəːnʧdəx
üxeglexü	uxəɡləx
üxerǰixü	uxərʤix
üxüxü	uxəx
üxügülxü	uxuːləx
üxüldexü	uxəldəx
üxüsirexü	uxʃrəx
üxüdxexü	uxətɡəx
üxüdxixü	uxədxiːx
üglexü	uɡləx
ügsexü	uɡsəx
ügserexü	uɡsrəx
ügtegexü	uɡtəːx
ügdelxü	uɡdləx
ügderexü	uɡdrəx~udrəx
ügeilexü	uɡeːləx
ügeisxexü	uɡeːsɡəx
ügeidexü	uɡeːdəx
ügeirexü	uɡeːrəx
ügegürexü	uɡeːɡuːrəx
ügelexü	uɡləx
ügelčexü	uɡəlʧix
ügesexü	uɡsəx
ügečilexü	uɡʧləx
ügerilexü	uɡəːrləx
ügerisixü	uɡəːrʃix
ügeritüxü	uɡəːrtəx
ügüčelexü	uːʧləx
ügürexü	uːrəx
ümexeirexü	umxiːrəx
ümürüülxü	umruːləx
ümürüüldexü	umruːldəx
ümtüxü	umtəx
ülexeitüxü	ulxiːtəx
ülexeirexü	ulxiːrəx
ülexü	uləx
ülegexü	uləːx
ülegüdexü	uluːdəx
ülemǰilexü	uləmʤləx
ülemǰidexü	uləmʤdəx
üledexü	uldəx
üledegexü	uldəːx
üliilexü	uliːləx
üliisixü	uliːʃix
üliitüxü	uliːtəx
üliirexü	uliːrəx
ülixü	uləx
üligelexü	uləɡləx
üligerlexü	ulɡərləx
üligerčilexü	ulɡərʧləx
ülidxexü	ultɡəx
üliyexü	uliəx
ülbeixü	ulbiːx
ülbegenexü	ulbəɡnəx
ülbegerdexü	uləbɡərdəx
ülbelǰexü	ulbəlʤix
ülxü	uləx
ülxüixü	ulxiːx
ülxügenexü	ulxəɡnəx
ülxügerdexü	ulxɡərdəx
ülxülǰexü	ulxəlʤix
ülgexü	ulɡəx
ülgegülxü	ulɡuːləx
ültülxü	ultləx
ültüsürexü	ultəsrəx
ültürexü	ultrəx
üldexü	uldəx
üsüglexü	usəɡləx
üsügčilexü	usəɡʧləx
üsülexü	usləx
üsütüxü	ustəx
üsüdexü	usdəx
üsüčixü	usʧix
üsürxilexü	usərxiːləx
üsürxü	usrəx
üsürgexü	usərɡəx
ütegerxexü	utəːrxəx
ütegerxü	utəːrəx
ütürixü	utrəx
ütürxü	utrəx
ütürmedexü	utrəmdəx
üdexü	udəx
üdegesülexü	udəːsləx
üdegerilexü	udəːrləx
üdelexü	udləx
üderilexü	udəːrləx
üdterlexü	utərləx
üǰexü	uʤix
üǰegdexü	uʤiɡdəx
üǰegülxü	uʤuːləx
üǰemǰilexü	uʤimʤləx
üǰeldüxü	uʤildəx
üǰelčexü	uʤilʧix
üǰilsixü	uʤilʃix
üǰirexü	uʤrəx
üǰügürxexü	uʤuːrxəx
üǰügürlexü	uʤuːrləx
üǰügürdexü	uʤuːrdəx
üǰülexü	uʤləx
üyelexü	ujləx
üyetüxü	ujtəx
üyečixü	ujʧix
üyečilexü	ujʧləx
üyerxexü	ujirxəx
üyerlexü	ujirləx
ürexü	urəx
üregdexü	urəɡdəx
üregdegülxü	urəɡduːləx
ürelexü	urləx
üresexü	ursəx
ürečilexü	urʧləx
üreǰixü	urʤix
üreǰigülxü	urʤuːləx
ürübtüldexü	urəbtəldəx
ürüxü	urəx
ürbisxü	urəbsəx~orobsox
ürgelexü	urəɡləx
ürgelesxixü	urəɡləsxiːx
ürgüxü	urɡəx
ürgügexü	urɡəːx
ürgülǰilexü	urɡəlʤləx
ürgülǰilegülxü	urɡəlʤluːləx
ürlexü	uːrləx
ürčiixü	urʧiːx
ürčiilgexü	urʧiːlɡəx
ürčibelǰexü	urʧbəlʤix
ürčiginexü	urʧiɡnəx
ürčigirtüxü	urʧɡərtəx
ürčigirdexü	urʧɡərdəx
ürčilegetüxü	urʧləːtəx
ürčilǰexü	urʧilʤix
ëü'ropačilaxu	jɔwrɔːpʧɪlɔx
naiguxu	næːɡɑx
naigugulxu	næːɡʊːlɑx
naigulǰaxu	næːɡɑlʤɪx
naitagaxu	næːtɑːx
naitagalgaxu	næːtɑːlɡɑx
naidaŋguilaxu	næːdɑŋɡʊɪlɑx
naidaŋguiraxu	næːdɑŋɡʊɪrɑx
naidaburilaxu	næːdbɑrlɑx
naidaburiǰigulxu	næːdbɑrʤʊːlɑx
naidaxu	næːdɑx
naiǰalaxu	næːʤlɑx
naiǰarxaxu	næːʤɪrxɑx
nairaxu	næːrɑx
nairagulxu	næːrʊːlɑx
nairamdaxu	næːrɑmdɑx
nairamdagulxu	næːrɑmdʊːlɑx
nairalduxu	næːrɑldɑx
nairlaxu	næːrlɑx
nandiŋnaxu	nændɑɡnɑx
nančixu	nɑnʧɪx
naŋsixu	nɑŋʃɪx
nabxaixu	nɑbxɪːx
nabxaganaxu	nɑbxɡɑnɑx
nabxagardaxu	nɑbxɡɑrdɑx
nabxalǰaxu	nɑbxɑlʤɪx
nabsaixu	nɑbsɪːx
nabsaganaxu	nɑbsɡɑnɑx
nabsagalǰaxu	nɑbsɡɑlʤɪx
nabsagardaxu	nɑbsɡɑrdɑx
nabsalǰaxu	nɑbsɑlʤɪx
nabsiixu	nɑbʃɪːx
nabsixu	nɑbʃɪx
nabsiganaxu	nɑbʃɡɑnɑx
nabsigardaxu	nɑbʃɡɑrdɑx
nabsilǰaxu	nɑbʃɪlʤɪx
nabtaixu	nɑbtɪːx
nabtaganaxu	nɑbtɡɑnɑx
nabtagalǰaxu	nɑbtɡɑlʤɪx
nabtagaraxu	nɑbtɑːrɑx
nabtagardaxu	nɑbtɡɑrdɑx
nabtagxixü	nɑbtɑɡxiːx
nabtalǰaxu	nɑbtɑlʤɪx
nabtasxixü	nɑbtɑsxiːx
nabtaraxu	nɑbtrɑx
nabčiixu	nɑbʧɪːx
nabčiganaxu	nɑbʧɡɑnɑx
nabčigardaxu	nɑbʧɡɑrdɑx
nabčilaxu	nɑbʧlɑx
nabčilǰaxu	nɑbʧɪlʤɪx
naxiixu	næxɪːx
naxiganaxu	næxɡɑnɑx
naxilxu	næxlɑx
naxilǰaxu	næxɪlʤɪx
naxisxixü	næxɪsxiːx
naxiyalaxu	næxɪɑlɑx
naxiraxu	næxrɑx
nagaxu	nɑːx
nagagurdaxu	nɑːɡʊːrdɑx
nagaliŋxailaxu	nɑːlɪŋxæːlɑx
nagaliŋxaituxu	nɑːlɪŋxæːtɑx
nagaliŋxairaxu	nɑːlɪŋxæːrɑx
nagalduxu	nɑːldɑx
nagaldugulxu	nɑːldʊːlɑx
nagasilaxu	nɑːʃlɑx
nagadxu	nɑːdɑx
nagačulaxu	nɑɡɑʧlɑx
nagurlaxu	nʊːrlɑx
nagtuxu	nɑɡtɑx
nagǰiixu	nɑɡʤɪːx
nagǰigardaxu	nɑɡʤɡɑrdɑx
namančilaxu	nɑmɑnʧlɑx
namagalaxu	nɑmɑːlɑx
namilǰaxu	næmɪlʤɪx
namisxixü	næmɪsxiːx
namiyarxaxu	nɑmjɑːrxɑx
namiraxu	næmrɑx
namuixu	nɑmɪːx
namuganaxu	nɑmɡɑnɑx
namugsixu	nɑmɑɡʃɪx
namugtuxu	nɑmɑɡtɑx
namugdaxu	nɑmɑɡdɑx
namugǰixu	nɑmɑɡʤɪx
namulǰaxu	nɑmɑlʤɪx
namusxixü	nɑmsxiːx
namursixu	nɑmɑrʃɪx
namurǰixu	nɑmɑrʤɪx
namurǰiyalaxu	nɑmɑrʤɑːlɑx
namnaxu	nɑmnɑx
nambaixu	nɑmbɪːx
nambaganaxu	nɑmbɑɡɑnɑx
nambagalaxu	nɑmbɑːlɑx
nambagarxaxu	nɑmbɑːrxɑx
nambagardaxu	nɑmbɑɡɑrdɑx
nambalǰaxu	nɑmbɑlʤɪx
namxaraxu	nɑmxɑrɑx
namxaragulxu	nɑmxɑrʊːlɑx
namtarčilaxu	nɑmtɑrʧlɑx
namdaxu	nɑmdɑx
namdagaxu	nɑmdɑːx
namdagulxu	nɑmdʊːlɑx
namǰixu	nɑmʤɪx
namǰigulxu	nɑmʤʊːlɑx
namǰiraxu	nɑmʤrɑx
namǰurdaxu	nɑmʤɪrdɑx
nalaixu	nɑlɪːx
nalaxu	nɑlɑx
nalagardaxu	nɑlɡɑrdɑx
nalagudaxu	nɑlʊːdɑx
nalaraxu	nɑlrɑx
nalixu	nælɪx
naliglaxu	nælɪɡlɑx
naliyadaxu	nælɪɑdɑx
nalxaixu	nɑlxɪːx
nalxagardaxu	nɑlxɡɑrdɑx
nalmaixu	nɑlmɪːx
nalmaganaxu	nɑlɑmɡɑnɑx
nalmagardaxu	nɑlɑmɡɑrdɑx
nalmalaxu	nɑlɑmlɑx
nalmalǰaxu	nɑlmɑlʤɪx
nalmaraxu	nɑlɑmrɑx
nalmiixu	nælmɪːx
nalmiganaxu	nælɪmɡɑnɑx
nalmigardaxu	nælɪmɡɑrdɑx
nalmilǰaxu	nælmɑlʤɪx
naldaixu	nɑldɪːx
naldaganaxu	nɑldɡɑnɑx
naldagardaxu	nɑldɡɑrdɑx
nalčalǰaxu	nɑlʧɪlʤɪx
nalčiixu	nɑlʧɪːx
nalčiganaxu	nɑlʧɡɑnɑx
nalčigardaxu	nɑlʧɡɑrdɑx
nalčilǰaxu	nɑlʧɪlʤɪx
nasilaxu	nɑːʃlɑx
nasilxu	nɑʃlɑx
nasidaxu	nɑːʃdɑx
nasulaxu	nɑslɑx
nasuǰixu	nɑsʤɪx
nadxuxu	nɑtɡɑx
nadxusxixü	nɑtɡɑsxiːx
naǰagairaxu	nɑʤɡæːrɑx
naǰiginaxu	nɑʤɪɡnɑx
naraguldaxu	nɑrʊːldɑx
narasixu	nɑrʃɪx
naračaxu	nɑrʧɪx
narintuxu	nærɪːntɑx
naribčilaxu	nærɪːbʧlɑx
narilaxu	nærɪːlɑx
narisxaxu	nærsɡɑx~nærɪːsɡɑx
narisxu	nærsɑx~nærɪːsɑx
narituxu	nærtɑx~nærɪːtɑx
naridaxu	nærdɑx~nærɪːdɑx
naridxaxu	nærtɡɑx~nærɪːtɡɑx
naridxu	nærtɑx~nærɪːtɑx
narxadaxu	nɑrxdɑx
nargixu	nærɡɪx
nargilduxu	nærɡɪldɑx
narmaixu	nɑrmɪːx
narmaganaxu	nɑrɑmɡɑnɑx
narmalǰaxu	nɑrmɑlʤɪx
neigemlexü	niːɡəmləx
neigemčilexü	niːɡəmʧləx
neigelexü	niːɡləx
neigedxü	niːɡdəx
neilexü	niːləx
neilegülxü	niːluːləx
neileldüxü	niːləldəx
neilelčexü	niːləlʧix
neilxü	niːləx
neislexü	niːsləx
neitelexü	niːtləx
neidemǰixü	niːdəmʤix
neidemǰigülxü	niːdəmʤuːləx
neidxexü	niːtɡəx
neidxerexü	niːtəɡrəx
neidxü	niːdəx
neičexü	niːʧix
neičilexü	niːʧləx
neŋdexü	nəŋdəx
neŋǰixü	nəɡʤix~nəŋʤix
nebseixü	nəbsiːx
nebsegenexü	nəbsəɡnəx
nebsegerdexü	nəbsɡərdəx
nebselǰexü	nəbsəlʤix
nebsirexü	nəbʃrəx
nebtegelǰexü	nəbtɡəlʤix
nebtelxü	nəbtləx
nebtelǰexü	nəbtəlʤix
nebterexü	nəbtrəx
nebteregülxü	nəbtruːləx
nebterelčexü	nəbtrəlʧix
nebčixü	nəbʧix
nebčigülxü	nəbʧuːləx
nebčirexü	nəbʧrəx
nexexü	nəxəx
nexemǰilexü	nəxəmʤləx
negǰixü	nəɡʤix
negegexü	nəːx
negegegdexü	nəːɡdəx
negüxü	nuːx
negügeltüxü	nuːɡəltəx
negülgexü	nuːlɡəx
negüdellexü	nuːdəlləx
negüresütüxü	nuːrstəx
negüresüǰixü	nuːrsʤix
negüresüǰigülxü	nuːrsʤuːləx
nemexü	nəməx
nemegdexü	nəməɡdəx
nemegdegülxü	nəməɡduːləx
nemegesülexü	nəməːsləx
nemegürexü	nəmuːrəx
nemerilexü	nəmərləx
nemüixü	nəmiːx
nemülǰexü	nəməlʤix
nemnexü	nəmnəx
nelüixü	nəliːx
nelülǰexü	nələlʤix
nelbeixü	nəlbiːx
nelxeixü	nəlxiːx
nelmeixü	nəlmiːx
nesrexü	nəsrəx
netirexü	nətrəx
netüixü	nətiːx
netübelǰexü	nətbəlʤix
netülǰexü	nətəlʤix
netüsxixü	nətəsxiːx
netürexü	nətrəx
nereidxü	nəriːdəx
nerexü	nərəx
neremǰilexü	nərəmʤləx
nerelexü	nərləx
nerelxexü	nərəlxəx
neresixü	nərʃix
neredxü	nərdəx
nerbexü	nərbəx
nerbegdexü	nərbəɡdəx
nermexü	nərməx
nermegesülexü	nərməːsləx
ninčidxu	nɪnʧdɑx
niŋtuxu	nɪŋtɑx
nibsirexü	nibʃrəx
nigsixü	niɡʃix
nigsigürexü	niɡʃuːrəx
nigedümelǰigülxü	nəɡdməlʤuːləx
nigedülǰixü	nəɡdəlʤix
nigedülǰigülxü	nəɡdəlʤuːləx
nigedxexü	nəɡtɡəx
nigedxü	nəɡdəx
nigedrexü	nəɡdrəx
nigečilexü	nəɡʧləx
nigixü	niːx
niguxu	nʊːx
nigugdaxu	nʊːɡdɑx
nigulčaxu	nʊːlʧɪx
nigučagailaxu	nʊːʧɡæːlɑx
nigučalaxu	nʊːʧlɑx
nigurlaxu	nuːrləx
nigurdaxu	nuːrdəx
nigurdagulxu	nuːrduːləx
nigurčilaxu	nuːrʧləx
nigülexü	nuɡləx
nigülesxü	niɡuːlsəx~nuːlsəx
nig°sixu	nɪɡʃɪx
nig°siraxu	nɪɡʃrɑx
nig°talaxu	nɪɡtlɑx
nig°taraxu	nɪɡtrɑx
nig°taralčaxu	nɪɡtrɑlʧɪx
nimbailaxu	nɪmbæːlɑx
nimbaidaxu	nɪmbæːdɑx
nimgelexü	niŋɡələx~nimɡələx
nimgedexü	niŋɡədəx~nimɡədəx
nimgedxexü	niŋɡətɡəx~nimɡətɡəx
nimgedxü	niŋɡətəx~nimɡətəx
nimgerexü	niŋɡərəx~nimɡərəx
nilaixu	nɪlɪːx
nilaxu	nɪlɑx
nilaganaxu	nɪlɡɑnɑx
nilagardaxu	nɪlɡɑrdɑx
nilalduxu	nɪlɑldɑx
niluguraxu	nɪlʊːrɑx
nilbuxu	nʊlmɑx
nilbulaxu	nʊlɑmlɑx
nilbusutuxu	nʊlmɑstɑx
nilbusutugulxu	nʊlmɑstʊːlɑx
nilxasixu	nɪlxʃɪx
nilxixü	nilxiːx
niltagsixu	nɪltɑɡʃɪx
niltalxu	nɪltlɑx
niltaraxu	nɪltrɑx
nilčaixu	nɪlʧɪːx
nilčagaidaxu	nɪlʧɡæːdɑx
nilčaganaxu	nɪlʧɡɑnɑx
nilčagardaxu	nɪlʧɡɑrdɑx
nilčalǰaxu	nɪlʧɪlʤɪx
nilčiginexü	nilʧiɡnəx
nilčuixu	nɪlʧɪːx
nilčuganaxu	nɪlʧɡɑnɑx
nisalxu	nɪslɑx
nisačixu	nɪsʧɪx
nisugutuxu	nɪʃʊːtɑx
nisutuxu	nʊstɑx
nisxaxu	nɪsɡɑx
nisxexü	nisɡəx
nisxü	nisəx
nitulxu	nɪtlɑx
nidečixü	nidʧix
niderexü	nidrəx
niduxalaxu	nɪdxɑlɑx
nidučixu	nʊdʧɪx
nidurxu	nʊdrɑx
nidurgalaxu	nʊdrɑɡlɑx
nidurgasixu	nʊdrɑɡʃɪx
nidurgadaxu	nʊdrɑɡdɑx
nidülexü	nudləx
nidxerxü	nitɡərəx
ničalxu	nɪʧlɑx
ničaraxu	nɪʧrɑx
ničiginaxu	nɪʧɪɡnɑx
ničuxu	nɪʧɪx
ničugaxu	nɪʧɑːx
ničügülexü	nuʧiɡləx
ničügürexü	nuʧiɡrəx
niǰiginexü	niʤiɡnəx
niyantuxu	nɪntɑx
nirailaxu	nɪræːlɑx
nirugubčilaxu	nʊrʊːbʧlɑx
nirugulaxu	nʊrʊːlɑx
niruguldaxu	nʊrʊːldɑx
nirugutuxu	nʊrʊːtɑx
nirxixü	nirxiːx
nirxirexü	nirxrəx
nirgexü	nirɡəx
nird'xixü	nirdxiːx
nirwalaxu	nɪrwɑːlɑx
noitalaxu	nœːtlɔx
noitadaxu	nœːtdɔx
noitadxu	nœːttɔx
noitaraxu	nœːtrɔx
noirmoglaxu	nœːrmɔɡlɔx
noirsoxu	nœːrsɔx
nooxailaxu	nɔːxœːlɔx
noologurlaxu	nɔːlʊːrlɑx
noololčaxu	nɔːlɔlʧɪx
noolxu	nɔːlɔx
nooraxu	nɔːrɔx
nooraglaxu	nɔːrɔɡlɔx
nobsilaxu	nɔbʃlɔx
nobsiraxu	nɔbʃrɔx
noxaituxu	nɔxœːtɔx
noxairaxu	nɔxœːrɔx
noxairxaxu	nɔxœːrxɔx
noxilxu	nœxlɔx
noxiyatuxu	nœxɪɔtɔx
noxu	nɔːx
nogogalaxu	nɔɡɔːlɔx
nogogadaxu	nɔɡɔːdɔx
nogogaraxu	nɔɡɔːrɔx
nogogaragulxu	nɔɡɔːrʊːlɑx
nogtolaxu	nɔɡtlɔx
nogdaxu	nɔːɡdɔx
nogdagulxu	nɔːɡdʊːlɑx
nomoilaxu	nɔmœːlɔx
nomoiraxu	nɔmœːrɔx
nomoxadxaxu	nɔmxɔtɡɔx
nomoxadxu	nɔmxɔtɔx
nomoxačilaxu	nɔmxɔʧlɔx
nomoxaraxu	nɔmxɔrɔx
nomogudxaxu	nɔmʊːtɡɑx
nomërlaxu	nɔːmerlɔx
nomlaxu	nɔmlɔx
nomčirxaxu	nɔmʧɪrxɔx
noliglaxu	nœlɪɡlɔx
nolčigardaxu	nɔlʧɡɔrdɔx
nočoxu	nɔʧɪx
nočogaxu	nɔʧɔːx
nočolduxu	nɔʧɪldɔx
noǰidlaxu	nɔʤɪdlɔx
noǰogoraxu	nɔʤɔːrɔx
noyalaxu	nɔjlɔx
noyarxaxu	nɔjɪrxɔx
noromlaxu	nɔrɔmlɔx
norxaidaxu	nɔrxœːdɔx
norxu	nɔrɔx
norgaxu	nɔrɡɔx
normalaxu	nɔːrɔmlɔx
nuuxatuxu	nʊːxtɑx
nuuraxu	nʊːrɑx
nuuragulxu	nʊːrʊːlɑx
nuuralduxu	nʊːrɑldɑx
nuntaglaxu	nʊntɑɡlɑx
nuntagsixu	nʊntɑɡʃɪx
nuntagraxu	nʊntɑɡrɑx
nunǰiixu	nʊnʤɪːx
nunǰigardaxu	nʊnʤɡɑrdɑx
nunǰidaxu	nʊnʤdɑx
nunǰiraxu	nʊnʤrɑx
nuŋsixu	nʊŋʃɪx
nuxuxu	nʊxɑx
nuxulaxu	nʊxlɑx
nuxulxilaxu	nʊxɑlxiːləx
nuxučixu	nʊxʧɪx
nuguluraxu	nʊɡɑlrɑx
nugulxu	nʊɡlɑx
nugusulaxu	nʊɡɑslɑx
nugučixu	nʊɡʧɪx
nuguraxu	nʊɡrɑx
nugduixu	nʊɡdɪːx
nugduganaxu	nʊɡdɡɑnɑx
nugdugalǰaxu	nʊɡdɡɑlʤɪx
nugdulǰaxu	nʊɡdɑlʤɪx
numulaxu	nʊmlɑx~nɔmlɔx
numudaxu	nʊmdɑx~nɔmdɔx
nuluganaxu	nʊlɡɑnɑx
nulgagaxu	nʊlɡɑːx
nulgulxu	nʊlɡɑlɑx
nulgučixu	nʊlɡɑʧɪx
nulguraxu	nʊlɡɑrɑx
nulmuxu	nʊlmɑx
nutalaxu	nʊtlɑx
nutalagdaxu	nʊtlɑɡdɑx
nutuglaxu	nʊtɑɡlɑx
nutugsixu	nʊtɑɡʃɪx
nutugsigulxu	nʊtɑɡʃʊːlɑx
nutugǰixu	nʊtɑɡʤɪx
nudučixu	nʊdʧɪx
nudurxu	nʊdrɑx
nuǰiginaxu	nʊʤɪɡnɑx
nuraxu	nʊrɑx
nuragaxu	nʊrɑːx
nurgixu	nʊrɡɪx
nurmaixu	nʊrmɪːx
nurmalaxu	nʊrɑmlɑx
nurmadaxu	nʊrɑmdɑx
nuršuxu	nʊrʃɪx
nuršugudaxu	nʊrʃʊːdɑx
nuršugudxu	nʊrʃʊːtɑx
nuršulaxu	nʊrʃlɑx
nöxöbörilexü	noxborlox
nöxöxü	noxox
nöxögesülexü	noxoːslox
nöxöčexü	noxʧix
nöxöčeldüxü	noxʧildox
nöxörlexü	noxorlox
nögčixü	noɡʧix
nögčigexü	noɡʧoːx
nögčirexü	noɡʧrox
nögexü	noːx
nögelxü	noːlox
nögelgelexü	noːloɡlox
nögečelexü	noːʧlox
nömöixü	nomoix
nömöilgexü	nomoilɡox
nömögelexü	nomoɡlox
nömögedexü	nomoɡdox
nömörilexü	nomorlox
nömöridexü	nomordox
nömörögülxü	nomruːləx
nömörxü	nomrox
nömörgexü	nomorɡox
nömörgelexü	nomroɡlox
nöletüxü	noltox
nölöxü	nolox
nölögelexü	noloːlox
nölögetüxü	noloːtox
nöǰitöxü	noʤtox
nöǰidlexü	noʤidlox
nöǰirexü	noʤrox
nörixü	norox
nörilexü	norlox
nörögetüxü	noroːtox
nüilxü	nuiləx
nüxelexü	nuxləx
nüxetüxü	nuxtəx
nügülxü	nuːləx
nüserxü	nusrəx
nüsertüxü	nusərtəx
nüserdexü	nusərdəx
nüdüxü	nudəx
nüǰiginexü	nuʤiɡnəx
nürxixü	nurxiːx
nürǰiginexü	nurʤiɡnəx
baiŋgusigulxu	bæːŋɡɑʃʊːlɑx
baiŋguraxu	bæːŋɡɑrɑx
baibaŋdaxu	bæːbɑŋdɑx
baixu	bæːx
baigulugdaxu	bæːɡʊːlɑɡdɑx
baigulxu	bæːɡʊːlɑx
bailaxu	bæːlɑx
bailgaxu	bæːlɡɑx
bailduxu	bæːldɑx
bailčaxu	bæːlʧɪx
baisxixü	bæːsxiːx
baituxu	bæːtɑx
baičaxu	bæːʧɪx
baičagaxu	bæːʧɑːx
baiǰanaxu	bæːʤnɑx
bairigusixu	bæːrɡɑʃɪx
bairilaxu	bæːrlɑx
bairilagulxu	bæːrlʊːlɑx
bairisixu	bæːrʃɪx
bairisigulxu	bæːrʃʊːlɑx
baifaŋdaxu	bæːfɑŋdɑx
bansadaxu	bɑnsdɑx
bansidaxu	bænʃdɑx
bantaixu	bɑntɪːx
bantaŋnaxu	bɑntɑɡnɑx
bantagairaxu	bɑntɡæːrɑx
bantaganaxu	bɑntɡɑnɑx
bantalǰaxu	bɑntɑlʤɪx
banǰixu	bɑnʤɪx
baŋxuixu	bɑŋxɪːx
baŋxurdaxu	bɑŋxɑrdɑx
baŋǰadaxu	bɑnʣdɑx
babaixu	bɑbɪːx
babanaxu	bɑbnɑx
babanadaxu	bɑbɑndɑx
babaganaxu	bɑbɡɑnɑx
babalǰaxu	bɑbɑlʤɪx
babatunaxu	bɑbtnɑx
baxaduxu	bɑxdɑx
baxarxaxu	bɑxɑrxɑx
baxarxu	bɑxrɑx
baxardaxu	bɑxɑrdɑx
baxixu	bæxɪx
baxigulxu	bæxɪʊlɑx
baxigudaxu	bæxɪʊdɑx
baxigudxu	bæxɪʊtɑx
baxidaxu	bæxdɑx
baxiraxu	bæxrɑx
baxirlaxu	bæxɪrlɑx
baxuutuxu	bɑxʊːtɑx
baganadaxu	bɑɡɑndɑx
bagabagaičilaxu	bɑːbɡæːʧlɑx
bagagigulxu	bɑːɡɪʊlɑx
bagaxu	bɑːx
bagagalaxu	bɑːlɑx
bagagixu	bɑːɡɪx
bagalaxu	bɑːlɑx
bagalǰuurdaxu	bɑɡɑlʤʊːrdɑx
bagasilaxu	bɑːʃlɑx
bagasudaxu	bɑːsdɑx
bagasxaxu	bɑɡɑsɡɑx
bagasxu	bɑɡsɑx
bagaturxaxu	bɑːtɑrxɑx
bagaturlaxu	bɑːtɑrlɑx
bagaturčilaxu	bɑːtɑrʧlɑx
bagadaxu	bɑɡdɑx
bagadaganaxu	bɑːdɡɑnɑx
bagadxaxu	bɑɡɑtɡɑx
bagadxu	bɑɡtɑx~bɑɡdɑx
bagačilaxu	bɑɡɑʧlɑx
bagaǰilaxu	bɑɡɑʤlɑx
bagaraxu	bɑːrɑx
bagubčilaxu	bʊɡʊːbʧlɑx
baguxu	bʊːx
bagulgaxu	bʊːlɡɑx
bagulgagulxu	bʊːlɡʊːlɑx
bagudalaxu	bʊːdlɑx
bagudallaxu	bʊːdɑllɑx
baguraxu	bʊːrɑx
baguragulxu	bʊːrʊːlɑx
bagurilaxu	bʊɪrlɑx
bagbaixu	bɑɡbɪːx
bagbagardaxu	bɑɡbɑɡɑrdɑx
bagburlaxu	bɑɡbɑrlɑx
baglaxu	bɑɡlɑx
baglaraxu	bɑɡlɑrɑx
bagluixu	bɑɡlɪːx
bagsaixu	bɑɡsɪːx
bagsagardaxu	bɑɡsɡɑrdɑx
bagsixu	bɑɡʃɪx
bagsilaxu	bɑɡʃlɑx
bagsiraxu	bɑɡʃrɑx
bagsiralduxu	bɑɡʃrɑldɑx
bagsirxaxu	bɑɡʃɪrxɑx
bagsurxu	bɑɡsrɑx
bagsurgalaxu	bɑɡsrɑɡlɑx
bagtaxu	bɑɡtɑx
bagtagaxu	bɑɡtɑːx
bagtalxu	bɑɡtlɑx
bagtalčaxu	bɑɡtɑlʧɪx
bagtaraxu	bɑɡtrɑx
bagčagalaxu	bɑɡʧɑːlɑx
bagčalaxu	bɑɡʧlɑx
bagǰaixu	bɑɡʤɪːx
bambaixu	bɑmbɪːx
bambailaxu	bɑmbæːlɑx
bambaganaxu	bɑmbɑɡɑnɑx
bambagalǰaxu	bɑmbɑɡɑlʤɪx
bambalǰaxu	bɑmbɑlʤɪx
bamtuxu	bɑmtɑx
balaituxu	bɑlæːtɑx
balairaxu	bɑlæːrɑx
balairagulxu	bɑlæːrʊːlɑx
balagalǰaxu	bɑlɡɑlʤɪx
balagadaxu	bɑlɡɑdɑx
balagdaxu	bɑlɑɡdɑx
balamagdaxu	bɑlmɑɡdɑx
balamadlaxu	bɑlmɑdlɑx
balalxu	bɑllɑx
baladaxu	bɑldɑx
balačixu	bɑlʧɪx
balaraxu	bɑlrɑx
balaragulxu	bɑlrʊːlɑx
balarxaisixu	bɑlɑrxæːʃɪx
baliyartuxu	bɑlɪɑrtɑx
balbaixu	bɑlbɪːx
balbaxu	bɑlbɑx
balbaganaxu	bɑlɑbɡɑnɑx
balbalxu	bɑlɑblɑx
balbalǰaxu	bɑlbɑlʤɪx
balbačixu	bɑlɑbʧɪx
balbaraxu	bɑlɑbrɑx
balxaixu	bɑlxɪːx
balxaganaxu	bɑlxɡɑnɑx
balxalǰaxu	bɑlxɑlʤɪx
balguxu	bɑlɡɑx
baltaixu	bɑltɪːx
baltaganaxu	bɑltɡɑnɑx
baltalxu	bɑltlɑx
baltalǰaxu	bɑltɑlʤɪx
baltadaxu	bɑltdɑx
balčaixu	bɑlʧɪːx
balčalǰaxu	bɑlʧɪlʤɪx
balčiginaxu	bɑlʧɪɡnɑx
balčigtuxu	bɑlʧɪɡtɑx
balčiruutuxu	bɑlʧrʊːtɑx
balčirdaxu	bɑlʧɪrdɑx
basildaxu	bɑʃɪldɑx
basirlaxu	bɑʃɪrlɑx
basuxu	bɑsɑx
basumǰilaxu	bɑsɑmʤlɑx
basxuxu	bɑsɡɑx
batulaxu	bɑtlɑx
batudxaxu	bɑtɑtɡɑx
batudxu	bɑttɑx
batuǰixu	bɑtʤɪx
baturxu	bɑtrɑx
badairaxu	bɑdæːrɑx
badanaxu	bɑdnɑx
badaglaxu	bɑdɑɡlɑx
badačixu	bɑdʧɪx
badaraxu	bɑdrɑx
badaragulxu	bɑdrʊːlɑx
badirlaxu	bædɪrlɑx
badirdaxu	bædɪrdɑx
badirčilaxu	bædɪrʧlɑx
badxixü	bɑdxiːx
badxuxu	bɑtɡɑx
badmalaxu	bɑdmɑːlɑx~bɑdɑmlɑx
badmaraxu	bɑdmɑːrɑx~bɑdɑmrɑx
badlaxu	bɑdlɑx
bačaglaxu	bɑʧɪɡlɑx
bačigudaxu	bɑʧʊːdɑx
bačimdaxu	bɑʧɪmdɑx
bačimdagulxu	bɑʧɪmdʊːlɑx
bačilaxu	bɑʧlɑx
baǰaxu	bɑʤɪx
baǰagaxu	bɑʤɑːx
baǰagdaxu	bɑʤɪɡdɑx
baǰalaxu	bɑʤlɑx
baǰaraxu	bɑʤrɑx
baǰaragulxu	bɑʤrʊːlɑx
baǰigdaxu	bɑʤɪɡdɑx
bayaglaxu	bɑjɪɡlɑx
bayalaxu	bɑjlɑx
bayaligǰixu	bɑjlɑɡʤɪx
bayasxaxu	bɑjsɡɑx
bayasxu	bɑjsɑx
bayaǰixu	bɑjʤɪx
bayarxaxu	bɑjɪrxɑx
bayarlaxu	bɑjɪrlɑx
baraxu	bɑrɑx
baragantuxu	bɑrɑːntɑx
baragandaxu	bɑrɑːndɑx
baragalaxu	bɑrɑːlɑx
baragalxaxu	bɑrɑːlxɑx
baragunsilaxu	bɑrʊːnʃlɑx
baragdaxu	bɑrɑɡdɑx
baralaxu	bɑrɑːlɑx
baralxaxu	bɑrɑːlxɑx
baradaxu	bɑrɑːdɑx
barintaglaxu	bærɪntɑɡlɑx
baribčilaxu	bærɪbʧlɑx
barixu	bærɪx
barigulxu	bærɪʊlɑx
barigudaxu	bærɪʊdɑx
barigudxaxu	bærɪʊtɡɑx
barigudxu	bærɪʊtɑx
barigdaxu	bærɪɡdɑx
barimalaxu	bærɪmlɑx
barimallaxu	bærmɑllɑx
barimtalaxu	bærɪmtlɑx
barimǰiyalaxu	bærɪmʤɑːlɑx
barimǰiyaǰigulxu	bærɪmʤɑːʤʊːlɑx
barilaxu	bærlɑx
barilduxu	bærɪldɑx
barilčaxu	bærɪlʧɪx
baričaxu	bærʧɪx
baričagalaxu	bærʧɑːlɑx
bariyačilaxu	bærɪɑʧlɑx
baruixu	bɑrɪːx
baruilgaxu	bɑrɪːlɡɑx
baruglaxu	bɑrɑɡlɑx
barugsiyaxu	bɑrɑɡʃɑːx
barugčaxu	bɑrɑɡʧɪx
barugčagaxu	bɑrɑɡʧɑːx
barugčagalaxu	bɑrɑɡʧɑːlɑx
barulǰaxu	bɑrɑlʤɪx
barbaixu	bɑrbɪːx
barxiraxu	bærxrɑx
barxiralduxu	bærxrɑldɑx
barlaxu	bɑrlɑx
barsaixu	bɑrsɪːx
bardaixu	bɑrdɪːx
bardaŋnaxu	bɑrdɑɡnɑx
bardaxu	bɑrdɑx
bardamnaxu	bɑrdɑmnɑx
bardamlaxu	bɑrdɑmlɑx
barčiixu	bɑrʧɪːx
barčilǰaxu	bɑrʧɪlʤɪx
barǰaixu	bɑrʤɪːx
barǰaŋtuxu	bɑrʤɪŋtɑx
barǰagardaxu	bɑrʤɡɑrdɑx
barǰiixu	bɑrʤɪːx
barǰigardaxu	bɑrʤɡɑrdɑx
benelexü	bənləx
bebeixü	bəbiːx
bebenexü	bəbnəx
bebenedexü	bəbəndəx
bebegenexü	bəbəɡnəx
bebitünexü	bəbtnəx
bebirexü	bəbrəx
bebüglexü	bəbəɡləx
bexeixü	bəxiːx
bexedexü	bəxdəx
begečeilexü	bəːʧiːləx
bexixü	bəxəx
bexilexü	bəxləx
bexiǰixü	bəxʤix
bexiǰigülxü	bəxʤuːləx
begterexü	bəɡtrəx
begčeixü	bəɡʧiːx
begčegenexü	bəɡʧiɡnəx
begčelǰexü	bəɡʧilʤix
begebeixü	bəːbiːx
begebeilexü	bəːbiːləx
begebegenexü	bəːbəɡnəx
begebelǰexü	bəːbəlʤix
begexü	bəːx
begelexü	bəːləx
begerexü	bəːrəx
begeregsixü	bəːrəɡʃix
begeregdexü	bəːrəɡdəx
begeritüxü	bəːrtəx
bembeixü	bəmbiːx
bembeilexü	bəmbiːləx
bembegenexü	bəmbəɡnəx
bembelǰexü	bəmbəlʤix
belensixü	bələnʃix
belenčilexü	bələnʧləx
beleŋdexü	bələŋdəx
beleŋčixü	bələŋʧix
beleŋčilexü	bələŋʧləx
beleglexü	bələɡləx
belelexü	bəlləx
beledügülxü	bəlduːləx
beledxexü	bəltɡəx
beledxü	bəldəx
belbesürexü	bələbsrəx
belxeixü	bəlxiːx
belxenexü	bəlxnəx
belxenčeglexü	bəlxənʧiɡləx
belxegenexü	bəlxəɡnəx
belxegüsülexü	bəlxuːsləx
belxemǰilexü	bəlxəmʤləx
belxelǰexü	bəlxəlʤix
belgelexü	bələɡləx
belgesiyexü	bələɡʃəːx
belgedexü	bələɡdəx
bellexü	bəlləx
beltergelexü	bəltrəɡləx
belčeixü	bəlʧiːx
belčegenexü	bəlʧiɡnəx
belčelǰexü	bəlʧilʤix
belčixü	bəlʧix
belčigexü	bəlʧəːx
belčigerlexü	bəlʧəːrləx
belčigerlegülxü	bəlʧəːrluːləx
belčigersixü	bəlʧəːrʃix
belčirlexü	bəlʧirləx
besereglexü	bəsrəɡləx
beseregdexü	bəsrəɡdəx
beterexü	bətrəx
bederixü	bədrəx
beyelexü	bəjləx
beyelegdexü	bəjləɡdəx
beyelegülxü	bəjluːləx
beyedexü	bəjdəx
beyečilexü	bəjʧləx
beyeǰixü	bəjʤix
beyerxexü	bəjirxəx
berilexü	bərləx
berilxexü	bərəlxəx
beričilexü	bərʧləx
beriyedexü	bərəːdəx
berbeixü	bərbiːx
berbegenexü	bərbəɡnəx
berbegerdexü	bərəbɡərdəx
berbelǰexü	bərbəlʤix
berxelexü	bərxləx
berxesixü	bərxʃix
berxesiyexü	bərxʃəːx
berxetüxü	bərxtəx
berlexü	bərləx
berseixü	bərsiːx
bersegütüxü	bərsuːtəx
bersixü	bərʃix
bertexü	bərtəx
bertüxü	bərtəx
berčiixü	bərʧiːx
berčilǰexü	bərʧilʤix
biirexü	biːrəx
biirelǰexü	biːrəlʤix
bindülexü	bindləx
bilaŋgadaxu	bɪlɑŋɡɑdɑx
bilaŋgačilaxu	bɪlɑŋɡɑʧlɑx
bilaxu	bɪlɑx
bilagaxu	bɪlɡɑx
bilagudaxu	bʊlʊːdɑx~bɪlʊːdɑx
bilaguraxu	bɪlʊːrɑx
bilagurdaxu	bɪlʊːrdɑx
bilardaxu	bɪlɑrdɑx
bilegüdexü	biluːdəx
bilbigürdexü	bilbuːrdəx
bilxaixu	bɪlxɪːx
bilxaxu	bɪlxɑx
bilxaganaxu	bɪlxɡɑnɑx
bilxagaxu	bɪlxɑːx
bilxalǰaxu	bɪlxɑlʤɪx
bilxaraxu	bɪlxrɑx
bilgegülxü	bilɡuːləx
biltaixu	bɪltɪːx
biltalxu	bɪltlɑx
bildaučilaxu	bɪldʊːʧlɑx
bildaurxaxu	bɪldʊːrxɑx
bildaxu	bɪldɑx
bilčaixu	bɪlʧɪːx
bilčautuxu	bɪlʧʊːtɑx
bilčaganaxu	bɪlʧɡɑnɑx
bilčalxu	bɪlʧlɑx
bilčalǰaxu	bɪlʧɪlʤɪx
bilčaraxu	bɪlʧrɑx
bisigürxexü	biʃuːrxəx
bisilgaxu	bɪʃɪlɡɑx
bisirexü	biʃrəx
bisiregülxü	biʃruːləx
bisirxexü	biʃirxəx
bisxigürdexü	biʃɡuːrdəx
bitegümǰilexü	bituːmʤləx
bitegülexü	bituːləx
bitegürexü	bituːrəx
bidaxu	bɪdɑx
bidaguraxu	bɪdʊːrɑx
biderlexü	bidərləx
bidüxü	bidəx
bičalxu	bɪʧlɑx
bičaraxu	bɪʧrɑx
bičixü	biʧix
bičiglexü	biʧiɡləx
bičigǰigülxü	biʧiɡʤuːləx
bičiginaxu	bɪʧɪɡnɑx
bičiginexü	biʧiɡnəx
biǰixü	biʤix
biǰitüxü	biʤtəx
biǰireütüxü	biʤruːtəx
biradaxu	bɪrdɑx
biridlexü	birdləx
birčiginexü	birʧiɡnəx
birǰiixü	birʤiːx
birǰireütüxü	birʤruːtəx
boilaxu	bœːlɔx
boidalaxu	bœːdɔːlɔx
boičoixu	bœːʧɪːx
boičogortoxu	bœːʧɡɔrtɔx
boiǰixu	bœːʤɪx
boiǰigulxu	bœːʤʊːlɑx
boiralaxu	bœːrlɔx
booduudaxu	bɔːdʊːdɑx
bontoixu	bɔntɔɪx
bontogonaxu	bɔntɡɔnɔx
bontolǰaxu	bɔntɔlʤɪx
boŋnoxu	bɔɡnɔx
boŋxoixu	bɔŋxɔɪx
boŋxogonaxu	bɔŋxɡɔnɔx
boŋxolǰaxu	bɔŋxɔlʤɪx
boŋsixu	bɔŋʃɪx
boboixu	bɔbɔɪx
bobogonaxu	bɔbɡɔnɔx
boxilaxu	bœxlɔx
boxitoxu	bœxtɔx
boxidaxu	bœxdɔx
boxiyatuxu	bœxɪɔtɔx
boxiyaraxu	bœxɪɔrɔx
boxirxu	bœxrɔx
boxirlaxu	bœxɪrlɔx
boxirtoxu	bœxɪrtɔx
bogonisxaxu	bœɡɪnsɡɔx
bogonisxu	bœɡɪnsɔx
bogonidaxu	bœɡɪndɔx
bogonidxaxu	bœɡɪntɡɔx
bogonidxu	bœɡɪntɔx
bogoxu	bɔːx
bogogdaxu	bɔːɡdɔx
bogomalaxu	bɔːmlɔx
bogomatuxu	bɔːmtɔx
bogomilaxu	bœːmlɔx
bogomidaxu	bœːmdɔx
bogolčilaxu	bɔːlʧlɔx
bogolǰuurdaxu	bɔɡɔlʤʊːrdɑx
bogosxu	bɔːsɔx
bogostoxu	bɔːstɔx
bogosraxu	bɔːsrɔx
bogodalaxu	bɔːdlɔx
bogodallaxu	bɔːdɔllɔx
bogočixu	bɔɡʧɪx
bogočilaxu	bɔɡɔʧlɔx
bogoǰilaxu	bɔːʤlɔx
bogorgilaxu	bœːrɔɡlɔx
bogsixu	bɔɡʃɪx
bogsigaxu	bɔɡʃɔːx
bogtolaxu	bɔɡtlɔx
bogdoixu	bɔɡdɔɪx
bogdogonaxu	bɔɡdɡɔnɔx
bogdolǰaxu	bɔɡdɔlʤɪx
bogčolaxu	bɔɡʧlɔx
bogǰoixu	bɔɡʤɪːx
bogǰoraxu	bɔɡʤrɔx
bomboixu	bɔmbɔɪx
bombogonaxu	bɔmbɔɡɔnɔx
bombolǰaxu	bɔmbɔlʤɪx
bolixu	bœlɪx
boligulxu	bœlɪʊlɑx
bolbasuraxu	bɔlɔbsrɔx
bolbasuragulxu	bɔlɔbsrʊːlɑx
bolxidaxu	bœlxdɔx
bolxičilaxu	bœlxʧɪlɔx
bolxu	bɔlɔx
bolgaxu	bɔlɡɔx
bolgixu	bœlɡɪx
bolgilaxu	bœlɡɪlɔx
bolgoxu	bɔlɡɔx
bolgogaxu	bɔlɡɔːx
bolgogasiragulxu	bɔlɡɔːʃrʊːlɑx
bolgomǰilaxu	bɔlɡɔːmʤlɔx
bolčoixu	bɔlʧɪːx
bolčogonaxu	bɔlʧɡɔnɔx
bolčolxixü	bɔlʧɔlxiːx
bolčolǰaxu	bɔlʧɪlʤɪx
bolǰoxu	bɔlʤɪx
bolǰogalaxu	bɔlʤɔːlɔx
bosxaxu	bɔsɡɔx
bosxoguraxu	bɔsɡʊːrɑx
bosxu	bɔsɔx
botilaxu	bœtlɔx
botogolaxu	bɔtɡɔlɔx
bodalaxu	bɔdlɔx
bodasǰixu	bœdɪsʤɪx
bodataiǰigulxu	bœdtœːʤʊːlɑx
bodačilaxu	bœdʧɪlɔx
bodoxu	bɔdɔx
bodogulxu	bɔdʊːlɑx
bodomoglaxu	bɔdmɔɡlɔx
bodolxilaxu	bɔdɔlxiːləx
bodolgasiraxu	bɔdlɔɡʃrɔx
bodxiraxu	bœtɡɪrɔx
borooxaidaxu	bɔrɔːxœːdɔx
boroolaxu	bɔrɔːlɔx
borootoxu	bɔrɔːtɔx
borogasixu	bɔrɔːʃɪx
borogdaxu	bɔrɔɡdɔx
borogǰixu	bɔrɔɡʤɪx
borolaxu	bɔrlɔx
borolagulxu	bɔrlʊːlɑx
borosixu	bɔrʃɪx
borbidaxu	bœrɪbdɔx
borgiyalaxu	bœrɡɪɔlɔx
borgiyatuxu	bœrɡɪɔtɔx
borgoxu	bɔrɡɔx
borgosixu	bɔrɡɔʃɪx
borsoxu	bɔrsɔx
bordoxu	bɔrdɔx
bordosolaxu	bɔrdɔslɔx
borčalaxu	bɔrʧlɔx
borčixu	bɔrʧɪx
builaxu	bʊɪlɑx
builalaxu	bʊɪllɑx
buidaxu	bʊɪdɑx
buulixu	bʊːlɪx
buusadaxu	bʊːsdɑx
buŋxulaxu	bʊŋxlɑx
bubaganaxu	bʊbɡɑnɑx
bubatunaxu	bʊbtnɑx
buxanaxu	bʊxnɑx
buxandailaxu	bʊxɑndæːlɑx
buxaxu	bʊxɑx
buxaldaxu	bʊxɑldɑx
buxasaxu	bʊxsɑx
buxatuxu	bʊxtɑx
buxarsixu	bʊxɑrʃɪx
buxiniduxu	bʊxɪndɑx~bœxɪndɔx
buxundailaxu	bʊxɑndæːlɑx
buguilidaxu	bʊɡʊɪldɑx
bugulsixu	bʊɡɑlʃɪx
bugultuxu	bʊɡɑltɑx
buguruixu	bʊːrɪːx
bugurultuxu	bʊːrɑltɑx
buglaxu	bʊɡlɑx
bugsaxu	bʊɡsɑx
bugsixu	bʊɡʃɪx
bumbaixu	bʊmbɪːx
bumbaganaxu	bʊmbɑɡɑnɑx
bumbalaxu	bʊmbɑlɑx
bumbalǰaxu	bʊmbɑlʤɪx
bumbadaxu	bʊmbɑdɑx
bulairaxu	bʊlæːrɑx
bulaŋgirtuxu	bʊlɑŋɡɪrtɑx
bulaxu	bʊlɑx
bulagtuxu	bʊlɑɡtɑx
bulasilaxu	bʊlʃlɑx
bularaxu	bʊlrɑx
bulixailaxu	bʊlxæːlɑx
bulixu	bʊlɪx
buligarilaxu	bʊlɡɑːrlɑx
buliyaxu	bʊlɪɑx~bɑlɑːx
buliyalduxu	bʊlɪɑldɑx~bɑlɑːldɑx
buliyalčaxu	bʊlɪɑlʧɪx~bɑlɑːlʧɪx
buliyačalduxu	bʊlɪɑʧɪldɑx~bɑlɑːʧɪldɑx
buluŋnaxu	bʊlɑɡnɑx
buluŋlaxu	bʊlɑŋlɑx
buluŋdaxu	bʊlɑŋdɑx
buludaxu	bʊldɑx
bulxaxu	bʊlxɑx
bulxuixu	bʊlxɪːx
bulxuganaxu	bʊlxɡɑnɑx
bulxulǰaxu	bʊlxɑlʤɪx
bulguxu	bʊlɡɑx
bulgulxu	bʊlɡɑlɑx
bulguraxu	bʊlɡɑrɑx
bultaixu	bʊltɪːx
bultailgaxu	bʊltɪːlɡɑx
bultaxu	bʊltɑx
bultaganaxu	bʊltɡɑnɑx
bultalxilaxu	bʊltɑlxiːləx
bultalxu	bʊltlɑx
bultalǰaxu	bʊltɑlʤɪx
bultasxixü	bʊltɑsxiːx
bultaraxu	bʊltrɑx
bultarixu	bʊltrɑx
buldaxu	bʊldɑx
buldagaxu	bʊldɑːx
bulduruutuxu	bʊldrʊːtɑx
bulčiixu	bʊlʧɪːx
bulčirxaituxu	bʊlʧɪrxæːtɑx
bulǰaxu	bʊlʤɪx
bulǰagaxu	bʊlʤɑːx
bulǰalxu	bʊlʤlɑx
bulǰaraxu	bʊlʤrɑx
busanixu	bʊsnɪx
busanigulxu	bʊsnɪʊlɑx
busaxilaxu	bʊsɑxlɑx
busigulaxu	bʊʃʊːlɑx
busurxu	bʊsrɑx
busurmaglaxu	bʊsɑrmɑɡlɑx
busxaxu	bʊsɡɑx
butanirgexü	bʊtnirɡəx
butalaxu	bʊtlɑx
butalxu	bʊtlɑx
butačixu	bʊtʧɪx
butaraxu	bʊtrɑx
butaragaxu	bʊtrɑːx~bʊtɑrɡɑx
butaragulxu	bʊtrʊːlɑx
budaŋtuxu	bʊdɑŋtɑx
budagalaxu	bʊdɑːlɑx~bɑdɑːlɑx
budaraxu	bʊdrɑx
buduŋguiraxu	bʊdɑŋɡʊɪrɑx
buduxu	bʊdɑx
buduglaxu	bʊdɑɡlɑx
budulixu	bʊdlɪx
buduliyantuxu	bʊdlɪɑntɑx
bučaxu	bʊʧɪx
bučagaxu	bʊʧɑːx
bučalxu	bʊʧlɑx
bučalgaxu	bʊʧɪlɡɑx
buǰagairaxu	bʊʤɡæːrɑx
buǰagairxaxu	bʊʤɡæːrxɑx
buǰamagairaxu	bʊʤɪmɡæːrɑx
buǰamagairxaxu	bʊʤɪmɡæːrxɑx
buǰarlaxu	bʊʤɪrlɑx
buǰartuxu	bʊʤɪrtɑx
buǰiginaxu	bʊʤɪɡnɑx
buǰiginagulxu	bʊʤɪɡnʊːlɑx
buǰiginalduxu	bʊʤɪɡnɑldɑx
buǰigirtuxu	bʊʤɡɪrtɑx
burantaglaxu	bʊrɑntɑɡlɑx
buraxu	bʊrɑx
burimadaxu	bʊrɪmdɑx
buruixu	bʊrɪːx
buruŋxuilaxu	bʊrɑŋxʊɪlɑx
burugulaxu	bʊrʊːlɑx
burugusiyaxu	bʊrʊːʃɑːx
burugudxaxu	bʊrʊːtɡɑx
burugudxu	bʊrʊːtɑx
burxantuxu	bʊrxɑntɑx
burxiraxu	bʊrxʲrɑx
burganixu	bʊrɡɑnɪx
burgaxu	bʊrɡɑx
burgixu	bʊrɡɪx~bœrɡɪx
burgilxu	bʊrɡɪlɑx~bœrɡɪlɔx
burguidaxu	bʊrɡʊɪdɑx
burtaglaxu	bʊrtɑɡlɑx
burd'xixü	bʊrdxiːx
burd'xilgexü	bʊrdxiːlɡəx
burčaglaxu	bʊrʧɪɡlɑx
burčiginaxu	bʊrʧɪɡnɑx
burǰaŋnaxu	bʊrʤɪɡnɑx
burǰaŋtuxu	bʊrʤɪŋtɑx
burǰiixu	bʊrʤɪːx
burǰiilgaxu	bʊrʤɪːlɡɑx
burǰigirtuxu	bʊrʤɡɪrtɑx
böntöixü	bontoix
böntögenexü	bontoɡnox
böntölǰexü	bontolʤix
böŋsixü	boŋʃix
böŋǰiginexü	boŋʤiɡnox
böxelexü	boxlox
böxečegexü	boxʧoːx
böxeǰixü	boxʤix
böxeǰigülxü	boxʤuːləx
böxerxexü	boxorxox
böxöixü	boxoix
böxöilgexü	boxoilɡox
böxöisxixü	boxoisxiːx
böxöxü	boxox
böxögexü	boxoːx
böxölǰexü	boxolʤix
böxösxixü	boxosxiːx
böxödexü	boxdox
böglexü	boɡlox
böglerexü	boɡlorox
bögtöixü	boɡtoix
bögtögenexü	boɡtoɡnox
bögtölǰexü	boɡtolʤix
bögtörixü	boɡtrox
bögčöixü	boɡʧiːx
bögčögenexü	boɡʧiɡnox
bögčölǰexü	boɡʧilʤix
bögensüglexü	boːsoɡlox
bögexü	boɡox
bögegenexü	boːɡnox
bögegenerexü	boːɡnorox
bögemnexü	boːmnox
bögemneldüxü	boːmnoldox
bögemnerexü	boːmnorox
bögemrexü	boːmrox
bögelexü	boːlox
bögelǰixü	boːlʤix
bögesütüxü	boːstox
bögečeilexü	boːʧiːlox
bögeǰilexü	boɡʤlox
bögereŋxeilexü	boːroŋxøːlox
bögereŋxeidexü	boːroŋxøːdox
bögereglexü	boːroɡlox
bögeredeŋtüxü	boːrdoŋtox
bömnöldüxü	bomnoldox
bömböixü	bomboix
bömböilexü	bomboilox
bömbögenexü	bomboɡnox
bömbögelexü	bomboɡlox
bömbögedexü	bomboɡdox
bömbölǰexü	bombolʤix
bömbörixü	bomborox
bömbörigelexü	bomboroːlox
bömbörigeldüxü	bomboroːldox
bölčöixü	bolʧiːx
bölčöilgexü	bolʧiːlɡox
bölčögenexü	bolʧiɡnox
bösxexü	bosɡox
böǰixü	boʤix
böǰiglexü	boʤiɡlox
böǰilxilexü	boʤilxiːləx
böǰireglexü	boʤroɡlox
böǰöixü	boʤiːx
börtöixü	bortoix
börtögenexü	bortoɡnox
börtölǰexü	bortolʤix
börtötöxü	borttox
büiletüxü	builtəx
büüdeixü	buːdiːx
büürxü	buːrəx
büürlexü	buːrləx
büŋnexü	buɡnəx
bübeilexü	buːbeːləx
bübünexü	bubnəx
büxülidexü	buxəldəx~boxoldox
bügxüxü	buxəx~boxox
bügsixü	buɡʃix~boɡʃix
bügsigülxü	buɡʃuːləx~boɡʃuːləx
bügterexü	buɡtrəx
bügčimdexü	buɡʧimdəx
bügegetüxü	buɡəːtəx~boɡoːtox
bülexü	buləx~bolox
bülixü	bulix~bolix
büligürdexü	buliurdəx~boliurdəx
bülidexü	buldəx~boldox
büličixü	bulʧix~bolʧix
büliyesxexü	buliəsɡəx~boliosɡox
büliyesxü	buliəsəx~boliosox
büliyedxexü	buliətɡəx~boliotɡox
büliyedxü	buliətəx~boliotox
büliyečexü	buliəʧix~bolioʧix
büliyerexü	buliərəx~boliorox
bülüŋnexü	buləɡnəx
bülüŋtüxü	buləŋtəx
bülüglexü	buləɡləx~boloɡlox
bülügǰixü	buləɡʤix~boloɡʤix
bülügǰigülxü	buləɡʤuːləx~boloɡʤuːləx
bülxüixü	bulxiːx~bolxoix
bülxügenexü	bulxəɡnəx~bolxoɡnox
bülxümdexü	bulxəmdəx~bolxomdox
bülxülǰexü	bulxəlʤix~bolxolʤix
bülteixü	bultiːx~boltoix
bülteilgexü	bultiːlɡəx~boltoilɡox
bülteŋnexü	bultəɡnəx~boltoɡnox
bültegenexü	bultəɡnəx~boltoɡnox
bültelxü	bultləx~boltlox
bültelǰexü	bultəlʤix~boltolʤix
bülterexü	bultrəx~boltrox
büselexü	busləx~boslox
büselegdexü	busləɡdəx~bosloɡdox
büselegürlexü	busluːrləx~bosluːrləx
büšügürxexü	buʃuːrxəx
bütenixü	butnəx~botnox
büteŋgisexü	butəŋɡəsəx~botoŋɡosox
bütexü	butəx~botox
bütegexü	butəːx~botoːx
bütüxü	butəx~botox
bütügexü	butəːx~botoːx
büdeŋgirexü	budəŋɡərəx
büdegirexü	budəɡrəx
büdügübčilexü	buduːbʧləx
büdügüligdexü	buduːləɡdəx
büdügüdexü	buduːdəx
büdügüdxexü	buduːtɡəx
büdügüdxü	buduːtəx
büdügürexü	buduːrəx
büdüčixü	budʧix~bodʧix
büdürixü	budrəx~bodrox
büdürxilexü	budərxiːləx~bodorxiːləx
büčelexü	buʧləx~boʧlox
büčixü	buʧix
bürixü	burəx~borox
bürilxü	burləx~borlox
bürilgexü	burəlɡəx~borolɡox
bürildüxü	burəldəx~boroldox
bürildügülxü	burəlduːləx~borolduːləx
büridügülxü	burduːləx~borduːləx
büridxexü	burtɡəx~bortɡox
büridxü	burdəx~bordox
büriǰixü	burʤix
büriyesülexü	burəːsləx~boroːslox
büriyedexü	burəːdəx~boroːdox
bürüŋxüilexü	burəŋxuiləx~boroŋxoilox
bürüŋxüidexü	burəŋxuidəx~boroŋxoidox
bürügsixü	burəɡʃix~boroɡʃix
bürügelǰexü	burɡəlʤix~borɡolʤix
bürülǰexü	burəlʤix~borolʤix
bürxüixü	burxiːx~borxoix
bürxüxü	burxəx~borxox
bürxüglexü	burxəɡləx~borxoɡlox
bürxügdegülxü	burxəɡduːləx~borxoɡduːləx
bürgixü	burɡəx
bürčeglexü	burʧiɡləx
bürčiginexü	burʧiɡnəx
bürǰüixü	burʤiːx~borʤiːx
pansalaxu	pɑnslɑx
paglaixu	pɑɡlɪːx
pagsaixu	pɑɡsɪːx
pagsixu	pɑɡʃɪx
pagdaixu	pɑɡdɪːx
pagdaganaxu	pɑɡdɡɑnɑx
pagdalǰaxu	pɑɡdɑlʤɪx
pambaixu	pɑmbɪːx
pambagardaxu	pɑmbɑɡɑrdɑx
palandaxu	pɑːlɑndɑx
palaŋdaxu	pɑːlɑŋdɑx
palxaixu	pɑlxɪːx
palxaganaxu	pɑlxɡɑnɑx
palxalǰaxu	pɑlxɑlʤɪx
paltaixu	pɑltɪːx
paltaganaxu	pɑltɡɑnɑx
paltalǰaxu	pɑltɑlʤɪx
palčiginaxu	pɑlʧɪɡnɑx
pasxixü	pɑsxiːx
padxixü	pɑdxiːx
pačiginaxu	pɑʧɪɡnɑx
pargixu	pærɡɪx
pargiyadaxu	pærɡɪɑdɑx
parčiginaxu	pɑrʧɪɡnɑx
pembeixü	pəmbiːx
pesxixü	pəsxiːx
perčiginexü	pərʧiɡnəx
pinteixü	pintiːx
piŋsaixu	pɪŋsɪːx
pilaixu	pɪlɪːx
pilalaxu	pɪllɑx
piltaixu	pɪltɪːx
pilčiginaxu	pɪlʧɪɡnɑx
pidxixü	pɪdxiːx
pičiginaxu	pɪʧɪɡnɑx
piǰiginexü	piʤiɡnəx
piyasxixü	pɪɑsxiːx
piyarxixü	pɪɑrxiːx
pirgixu	pɪrɡɪx
pirgiyadaxu	pɪrɡɪɑdɑx
pirčiginaxu	pɪrʧɪɡnɑx
pogsixu	pɔɡʃɪx
pogdoixu	pɔɡdɔɪx
pogdogonaxu	pɔɡdɡɔnɔx
pogdolǰaxu	pɔɡdɔlʤɪx
poloŋxixü	pɔlɔŋxiːx
pologtoxu	pɔlɔɡtɔx
polxixü	pɔlxiːx
porxixü	pɔrxiːx
porgixu	pœrɡɪx
pord'xixü	pɔrdxiːx
porčiginaxu	pɔrʧɪɡnɔx
puudaxu	pʊːdɑx
pömböixü	pomboix
pömbögerdexü	pomboɡordox
pölöŋxixü	poloŋxiːx
pölčiginexü	polʧiɡnox
püliyexü	puleːx
püsxixü	pusxiːx
pürd'xixü	purdxiːx
pürčiginexü	purʧiɡnəx
pëŋnexü	pəɡnəx
pëŋselexü	pəŋsləx
xainčaxu	xæːnʧɪx
xaiŋgusixu	xæːŋɡɑʃɪx
xaiŋgutuxu	xæːŋɡɑtɑx
xaiŋgudaxu	xæːŋɡɑdɑx
xaiŋguraxu	xæːŋɡɑrɑx
xaibaixu	xæːbɪːx
xaibaxu	xæːbɑx
xaibaganaxu	xæːbɡɑnɑx
xaibalǰaxu	xæːbɑlʤɪx
xaixu	xæːx
xaixurxu	xæːxrɑx
xaigullaxu	xæːɡʊːllɑx
xailaxu	xæːlɑx
xailugulxu	xæːlʊːlɑx
xailxu	xæːlɑx
xaidaglaxu	xæːdɑɡlɑx
xaidagsixu	xæːdɑɡʃɪx
xaičilaxu	xæːʧlɑx
xairalaxu	xæːrlɑx
xairxu	xæːrɑx
xairgudaxu	xæːrɡɑdɑx
xairsulaxu	xæːrslɑx
xairčaglaxu	xæːrʧɪɡlɑx
xaugixu	xʊːɡɪx
xaulilaxu	xʊɪllɑx
xaulidaxu	xʊɪldɑx
xauličilaxu	xʊɪlʧlɑx
xauraidaxu	xʊːræːdɑx
xauraxu	xʊːrɑx
xanaixu	xɑnɪːx
xanaxu	xɑnɑx
xanalǰaxu	xɑnɑlʤɪx
xanačilaxu	xɑnʧlɑx
xanaraxu	xɑnrɑx
xanilaxu	xænlɑx
xanisaxu	xænsɑx
xanisiyaxu	xænʃɑːx
xaničaxu	xænʧɪx
xaniyaxu	xɑnɪɑx
xaniyalgaxu	xɑnɪɑlɡɑx
xanirxaxu	xænɪrxɑx
xanugulxu	xɑnʊːlɑx
xantaixu	xɑntɪːx
xantaganaxu	xɑntɡɑnɑx
xantalǰaxu	xɑntɑlʤɪx
xantarxu	xɑntrɑx
xandalaxu	xɑndlɑx
xanduxu	xɑndɑx
xančuilaxu	xɑnʧɪːlɑx
xančulaxu	xɑnʧɪːlɑx
xanǰulaxu	xɑnʤlɑx
xaŋxaixu	xɑŋxæːx
xaŋxailaxu	xɑŋxæːlɑx
xaŋxaganaxu	xɑŋxɡɑnɑx
xaŋxalǰaxu	xɑŋxɑlʤɪx
xaŋxu	xɑnɑx
xaŋxulxu	xɑŋxlɑx
xaŋgailaxu	xɑŋɡæːlɑx
xaŋgairaxu	xɑŋɡæːrɑx
xaŋgaxu	xɑŋɡɑx
xaŋgadaxu	xɑŋɡɑdɑx
xaŋgaraxu	xɑŋɡɑrɑx
xaŋginaxu	xæŋɡɪnɑx
xaŋginagulxu	xæŋɡɪnʊːlɑx
xaŋgixu	xæŋɡɪx
xaŋgirxixü	xæŋɡɪrxiːx
xaŋgirčaxu	xæŋɡɪrʧɪx
xaŋsaxu	xɑŋsɑx
xaŋsilaxu	xɑŋʃlɑx
xaŋdaxu	xɑŋdɑx
xaŋǰalxu	xɑɡʤlɑx~xɑŋʤlɑx
xaŋǰačixu	xɑɡʤʧɪx~xɑŋʤʧɪx
xaŋǰaraxu	xɑɡʤrɑx~xɑŋʤrɑx
xabaxu	xɑbɑx
xabisulaxu	xæbslɑx
xabidaxu	xæbdɑx
xabidagulxu	xæbdʊːlɑx
xabičixu	xæbʧɪx
xabirulduxu	xæbrɑldɑx
xabirxu	xæbrɑx
xabirgalaxu	xæbrɑɡlɑx
xabirgadaxu	xæbrɑɡdɑx
xabuŋnaxu	xɑbɑɡnɑx
xabuŋtuxu	xɑbɑŋtɑx
xabuxu	xɑbɑx
xabudartuxu	xɑbdɑrtɑx
xabudxu	xɑbdɑx
xabursixu	xɑbɑrʃɪx
xaburǰixu	xɑbɑrʤɪx
xaburǰiyalaxu	xɑbɑrʤɑːlɑx
xabxagasulaxu	xɑbxɑːslɑx
xabxaglaxu	xɑbxɑɡlɑx
xabxadaxu	xɑbxdɑx
xabginaxu	xæbɡɪnɑx
xabginalduxu	xæbɡɪnɑldɑx
xabsarxu	xɑbsrɑx
xabsargalaxu	xɑbsrɑɡlɑx
xabsargadaxu	xɑbsrɑɡdɑx
xabsixu	xɑbʃɪx
xabsuxu	xɑbsɑx
xabsurulčaxu	xɑbsrɑlʧɪx
xabsurxu	xɑbsrɑx
xabsurgaxu	xɑbsɑrɡɑx
xabtaixu	xɑbtɪːx
xabtagailaxu	xɑbtɡæːlɑx
xabtagaidaxu	xɑbtɡæːdɑx
xabtagairaxu	xɑbtɡæːrɑx
xabtagairagulxu	xɑbtɡæːrʊːlɑx
xabtaganaxu	xɑbtɡɑnɑx
xabtagalaxu	xɑbtɡɑlɑx
xabtalǰaxu	xɑbtɑlʤɪx
xabtasulaxu	xɑbtɑslɑx
xabčiixu	xɑbʧɪːx
xabčixu	xɑbʧɪx
xabčiganaxu	xɑbʧɡɑnɑx
xabčigulxu	xɑbʧʊːlɑx
xabčigurdaxu	xɑbʧʊːrdɑx
xabčigdaxu	xɑbʧɪɡdɑx
xabčilaxu	xɑbʧlɑx
xabčiyarilaxu	xɑbʧɑːrlɑx
xabǰiginaxu	xɑbʤɪɡnɑx
xaxaxu	xɑxɑx
xaxalaxu	xɑːxɑːlɑx
xaxalǰaxu	xɑːxɑlʤɪx
xaxinaxu	xæxnɑx
xaxixu	xæxɪx
xaxirxu	xæxrɑx
xaxuulilaxu	xɑxʊːllɑx
xaxuulidaxu	xɑxʊːldɑx
xaxunaxu	xɑxnɑx
xaxuraxu	xɑxʊːrɑx~xɑxrɑx
xagaxu	xɑːx
xagagaxu	xɑːx
xagagdaxu	xɑːɡdɑx
xagalburilaxu	xɑɡɑlbɑrlɑx
xagalburlaxu	xɑɡɑlbɑrlɑx
xagalxu	xɑɡlɑx
xagaslaxu	xɑɡɑslɑx
xagačailaxu	xɑːʧɪːlɑx
xagačaxu	xɑɡʧɪx
xagačagaxu	xɑɡʧɑːx
xagačagulxu	xɑɡʧʊːlɑx
xagačixu	xɑɡʧɪx
xagaǰituxu	xɑːʤtɑx
xagaraxu	xɑɡrɑx
xagarixu	xæːrɑx
xagariguldaxu	xæːrʊːldɑx
xagumagailaxu	xʊːmɡæːlɑx
xagumagaituxu	xʊːmɡæːtɑx
xagulxu	xʊːlɑx
xagudamnaxu	xʊːdɑmnɑx
xagudamlaxu	xʊːdɑmlɑx
xagudamtuxu	xʊːdɑmtɑx
xagučixu	xʊːʧɪx
xagučidaxu	xʊːʧdɑx
xagučiraxu	xʊːʧrɑx
xagučirxaxu	xʊːʧɪrxɑx
xagurailaxu	xʊːræːlɑx
xaguraxu	xʊːrɑx
xagurxu	xʊːrɑx
xagurgalaxu	xʊːrɡɑlɑx
xagurmaglaxu	xʊːrmɑɡlɑx
xagurmagsixu	xʊːrmɑɡʃɪx
xagurtaxu	xʊːrtɑx
xagurčaglaxu	xʊːrʧɪɡlɑx
xaglaxu	xɑɡlɑx
xagsaxu	xɑɡsɑx
xagsagaxu	xɑɡsɑːx
xagsaraxu	xɑɡsrɑx
xagsaragulxu	xɑɡsrʊːlɑx
xagsixu	xɑɡʃɪx
xagsigurdaxu	xɑɡʃʊːrdɑx
xagsiraxu	xɑɡʃrɑx
xagtuxu	xɑɡtɑx
xagdalaxu	xɑɡdlɑx
xagdaraxu	xɑɡdrɑx
xagǰalxu	xɑɡʤlɑx
xagǰačixu	xɑɡʤʧɪx
xagǰaraxu	xɑɡʤrɑx
xagǰixu	xɑɡʤɪx
xamagalaxu	xɑmɡɑːlɑx
xamagutuxu	xɑmʊːtɑx
xamaguraxu	xɑmʊːrɑx
xamagčilaxu	xɑmɑɡʧlɑx
xamarlaxu	xɑmɑrlɑx
xamarsixu	xɑmɑrʃɪx
xamardaxu	xɑmɑrdɑx
xamiyadaxu	xɑmɑːdɑx
xamiyadagulxu	xɑmɑːdʊːlɑx
xamiyarxu	xɑmɑːrɑx
xamuxu	xɑmɑx
xamugurdaxu	xɑmʊːrdɑx
xamurugulxu	xɑmrʊːlɑx
xamurxu	xɑmrɑx
xamxaixu	xɑmxɪːx
xamxalxu	xɑmxɑlɑx
xamxačixu	xɑmxɑʧɪx
xamxaraxu	xɑmxɑrɑx
xamxixu	xæmxɪx
xamsaxu	xɑmsɑx
xamsiixu	xɑmʃɪːx
xamsiilgaxu	xɑmʃɪːlɡɑx
xamsiraxu	xɑmʃrɑx
xamtudxaxu	xɑmtɑtɡɑx
xamtudxu	xɑmtdɑx
xamtuǰixu	xɑmtʤɪx
xamtuǰigulxu	xɑmtʤʊːlɑx
xamturaxu	xɑmtrɑx
xamturalǰixu	xɑmtrɑlʤɪx
xamturalǰigulxu	xɑmtrɑlʤʊːlɑx
xamturaǰixu	xɑmtɑrʤɪx
xamturaǰigulxu	xɑmtɑrʤʊːlɑx
xamǰixu	xɑmʤɪx
xamǰilčaxu	xɑmʤɪlʧɪx
xalaixu	xɑlɪːx
xalaxu	xɑlɑx
xalagaxu	xɑlɑːx
xalagalaxu	xɑlɑːlɑx
xalagudaxu	xɑlʊːdɑx
xalagudxaxu	xɑlʊːtɡɑx
xalagudxu	xɑlʊːtɑx
xalagučaxu	xɑlʊːʧɪx
xalaguraxu	xɑlʊːrɑx
xalaglaxu	xɑlɑɡlɑx
xalagdaxu	xɑlɑɡdɑx
xalamsaxu	xɑlɑmsɑx
xalamǰilaxu	xɑlɑmʤlɑx
xalasaxu	xɑlsɑx
xalasaguraxu	xɑlsʊːrɑx
xalasiraxu	xɑlʃrɑx
xaladaxu	xɑldɑx
xalibilǰaxu	xælbɑlʤɪx
xalibdaxu	xælɪbdɑx
xalixu	xælɪx
xaliguraxu	xælɪʊrɑx
xalimnaxu	xælɪmnɑx
xalimlaxu	xælɪmlɑx
xalimtuxu	xælɪmtɑx
xalimdaxu	xælɪmdɑx
xalisulaxu	xælslɑx
xalisutuxu	xælstɑx
xalidxu	xældɑx
xaliyalaxu	xælɪɑlɑx
xaliyadaxu	xælɪɑdɑx
xalusxu	xælsɑx
xalurixu	xælrɑx
xalurisxixü	xælrɑsxiːx
xalbaixu	xɑlbɪːx
xalbaganaxu	xɑlɑbɡɑnɑx
xalbagalaxu	xɑlbɑɡlɑx~xɑblɑɡlɑx
xalbagadaxu	xɑlbɑɡdɑx~xɑblɑɡdɑx
xalbagardaxu	xɑlɑbɡɑrdɑx
xalbalǰaxu	xɑlbɑlʤɪx
xalxaixu	xɑlxɪːx
xalxabčilaxu	xɑlxɑbʧlɑx
xalxaganaxu	xɑlxɡɑnɑx
xalxalaxu	xɑlxlɑx
xalxalǰaxu	xɑlxɑlʤɪx
xalxu	xɑlɑx
xalgaxu	xɑlɡɑːx
xalgixu	xælɡɪx
xalgilaxu	xælɡɪlɑx
xalgiraxu	xælɡɪrɑx
xalguudaxu	xɑlɡʊːdɑx
xalguxu	xɑlɡɑx
xalgurixu	xɑlɡɑrɑx
xalguridaxu	xɑlɡɑrdɑx
xalmaxu	xɑlmɑx
xaltaŋtuxu	xɑltɑŋtɑx
xaltačixu	xɑltʧɪx
xaltartuxu	xɑltɑrtɑx
xaltugunaxu	xɑltɡɑnɑx
xalturixu	xæltrɑx
xaldaburilaxu	xɑldbɑrlɑx
xaldaxu	xɑldɑx
xaldagaxu	xɑldɑːx
xalčagailaxu	xɑlʧɡæːlɑx
xalčagaidaxu	xɑlʧɡæːdɑx
xalčagaidxu	xɑlʧɡæːtɑx
xalčagaičilaxu	xɑlʧɡæːʧlɑx
xalčagairaxu	xɑlʧɡæːrɑx
xalčalxu	xɑlʧlɑx
xalčaraxu	xɑlʧrɑx
xalčiixu	xɑlʧɪːx
xalčixu	xɑlʧɪx
xalčiganaxu	xɑlʧɡɑnɑx
xalčigardaxu	xɑlʧɡɑrdɑx
xalčilǰaxu	xɑlʧɪlʤɪx
xalǰantuxu	xɑlʤɪntɑx
xalǰalaxu	xɑlʤlɑx
xalǰaraxu	xɑlʤrɑx
xasixu	xɑʃɪx
xasiglaxu	xɑʃɪɡlɑx
xasiyalaxu	xɑʃɑːlɑx
xasiraxu	xɑʃrɑx
xasiragaxu	xɑʃrɑːx
xasirlaxu	xɑʃɪrlɑx
xasirǰixu	xɑʃɪrʤɪx
xasuxu	xɑsɑx
xasxirxu	xɑʃɪɡrɑx
xašaŋnaxu	xɑʃɪɡnɑx
xašaŋdaxu	xɑʃɪŋdɑx
xatairtuxu	xɑtæːrtɑx
xataŋgiraxu	xætɑŋɡɪrɑx
xataŋgirtuxu	xætɑŋɡɪrtɑx
xataxu	xɑtɑx
xatagaxu	xɑtɑːx
xatagudaxu	xɑtʊːdɑx
xatagudxu	xɑtʊːtɑx
xataguǰixu	xɑtʊːʤɪx
xataguǰigulxu	xɑtʊːʤʊːlɑx
xataguraxu	xɑtʊːrɑx
xatagurxaxu	xɑtʊːrxɑx
xatarixu	xætrɑx
xaturxaxu	xɑtɑrxɑx
xadauxu	xɑdʊːx
xadaŋsixu	xɑdɑŋʃɪx
xadaxu	xɑdɑx
xadaganaxu	xɑdɡɑnɑx
xadagalaxu	xɑdɡɑlɑx
xadagalagulxu	xɑdɡɑlʊːlɑx
xadamadlaxu	xɑdɑmdlɑx
xadamlaxu	xɑdɑmlɑx
xadamčilaxu	xɑdɑmʧlɑx
xaduuraxu	xɑdʊːrɑx
xaduxu	xɑdɑx
xadugalaxu	xɑdɑːlɑx
xadugurdaxu	xɑdʊːrdɑx
xadurxu	xɑdrɑx
xadxuxu	xɑtɡɑx
xadxugurlaxu	xɑtɡʊːrlɑx
xadxumallaxu	xɑtɡɑmɑllɑx
xadxulaxu	xɑtɡɑlɑx
xadxulduxu	xɑtɡɑldɑx
xačarlaxu	xɑʧɪrlɑx
xačixu	xɑʧɪx
xačirxaxu	xɑʧɪrxɑx
xačirlaxu	xɑʧɪrlɑx
xaǰaixu	xɑʤɪːx
xaǰailgaxu	xɑʤɪːlɡɑx
xaǰabalǰaxu	xɑʤbɑlʤɪx
xaǰaxu	xɑʤɪx
xaǰaganaxu	xɑʤɡɑnɑx
xaǰagarlaxu	xɑʤɑːrlɑx
xaǰagardaxu	xɑʤɡɑrdɑx
xaǰagardaxu	xɑʤɑːrdɑx
xaǰagulaxu	xɑʤʊːlɑx
xaǰagulxu	xɑʤʊːlɑx
xaǰalaxu	xɑʤlɑx
xaǰalǰaxu	xɑʤɪlʤɪx
xaǰixu	xɑʤɪx
xaǰiglaxu	xɑʤɪɡlɑx
xaǰilgalaxu	xɑʤlɑɡlɑx
xaǰirlaxu	xɑʤɪrlɑx
xayančaxu	xæːnʧɪx
xayaxu	xɑjɪx
xayagabčilaxu	xɑjɑːbʧlɑx
xayagalaxu	xɑjɑːlɑx
xayagaraxu	xɑjɑːrɑx
xayagurdaxu	xɑjʊːrdɑx
xayagdaxu	xɑjɪɡdɑx
xayalaxu	xɑjlɑx
xaraixu	xɑræːx
xarailaxu	xɑræːlɑx
xarautuxu	xɑrʊːtɑx
xaraŋguilaxu	xɑrɑŋɡʊɪlɑx
xaraŋguidaxu	xɑrɑŋɡʊɪdɑx
xaraŋgusxu	xɑrɑŋɡɑsɑx
xaraŋgudxu	xɑrɑŋɡɑdɑx
xaraxu	xɑrɑx
xaragalaxu	xɑrɑːlɑx
xaragalǰaxu	xɑrɡɑlʤɪx
xaragulxu	xɑrʊːlɑx
xaragdaxu	xɑrɑɡdɑx
xaramnaxu	xɑrɑmnɑx
xaramlaxu	xɑrɑmlɑx
xaramsaxu	xɑrɑmsɑx
xaralaxu	xɑrlɑx
xarasaxu	xɑrsɑx
xarasixu	xɑrʃɪx
xarasudaxu	xɑrsdɑx
xaradaxu	xɑrdɑx
xaraǰalaxu	xɑrʤlɑx
xarixu	xærɪx
xarigulaxu	xærɪʊlɑx
xarigulxu	xærɪʊlɑx
xarigusxaxu	xærɪʊsɡɑx
xarigučaxu	xærɪʊʧɪx
xarilaxu	xærlɑx
xarilxaxu	xærɪlxɑx
xarilčaxu	xærɪlʧɪx
xarisaxu	xærsɑx
xaridaxu	xærdɑx
xaričaxu	xærʧɪx
xaričagulxu	xærʧʊːlɑx
xariyaxu	xɑrɑːx
xariyalaxu	xɑrɪɑlɑx
xariyalagdaxu	xɑrɪɑlɑɡdɑx
xaruxu	xɑrɑx
xaruguldaxu	xɑrʊːldɑx
xarbiŋnaxu	xærbɑɡnɑx
xarbiŋtuxu	xærbɑŋtɑx
xarbuxu	xɑrbɑx
xarbulaxu	xɑrɑblɑx
xargislaxu	xærɡɪslɑx
xarguxu	xɑrɡɑx
xargugulxu	xɑrɡʊːlɑx
xargulduxu	xɑrɡɑldɑx
xargučaxu	xɑrɡɑʧɪx
xargučalduxu	xɑrɡɑʧɪldɑx
xarmaxu	xɑrmɑx
xarmalaxu	xɑrmɑːlɑx
xarsixu	xɑrʃɪx
xarsilaxu	xɑrʃlɑx
xarsilduxu	xɑrʃɪldɑx
xard'xixü	xɑrdxiːx
xarčiixu	xɑrʧɪːx
xarčiginaxu	xɑrʧɪɡnɑx
xarǰaixu	xɑrʤɪːx
xarǰagardaxu	xɑrʤɡɑrdɑx
xarǰiginaxu	xɑrʤɪɡnɑx
xeilexü	xiːləx
xeisbürilexü	xiːsbərləx
xeisbüriǰixü	xiːsbərʤix
xeisbüriǰigülxü	xiːsbərʤuːləx
xeisxexü	xiːsɡəx
xeisxü	xiːsəx
xeitüxü	xiːtəx
xeitügülxü	xiːtuːləx
xeidexü	xiːdəx
xeirxexü	xiːrxəx
xeüxeldeiǰixü	xuːxəldeːʤix
xeüxirxü	xuːxrəx
xeülxü	xuːləx
xeüsilexü	xuːʃləx
xeüdeilexü	xuːdeːləx
xeüčixü	xuːʧix
xeürexü	xuːrəx
xeüregsixü	xuːrəɡʃix
xeürsixü	xuːrʃix
xenegerxexü	xənəːrxəx
xenteglexü	xəntəɡləx
xenǰelexü	xənʤləx
xenǰedexü	xənʤdəx
xeŋxüixü	xəŋxiːx
xeŋxülǰexü	xəŋxəlʤix
xeŋgergedexü	xəŋɡərəɡdəx
xeŋsixü	xəŋʃix
xeŋsigülxü	xəŋʃuːləx
xebeixü	xəbiːx
xebeilexü	xəbiːləx
xebeneglexü	xəbnəɡləx
xeberegsixü	xəbrəɡʃix
xebixü	xibəx
xebislexü	xibsləx
xebirexü	xibrəx
xeblexü	xəbləx
xeblegülxü	xəbluːləx
xebsinexü	xəbʃnəx
xebsixü	xəbʃix
xebsigülxü	xəbʃuːləx
xebsirexü	xəbʃrəx
xebtexü	xəbtəx
xebčeglexü	xəbʧiɡləx
xebčegdexü	xəbʧiɡdəx
xebčegeidexü	xəbʧɡeːdəx
xebčegeirxexü	xəbʧɡeːrxəx
xebčiyelexü	xəbʧəːləx
xebǰigülxü	xəbʤuːləx
xexelexü	xəːxəːləx
xexerexü	xəxrəx
xexeregülxü	xəxruːləx
xexüixü	xəxiːx
xexüilxilexü	xəxiːlxiːləx
xexüilgexü	xəxiːlɡəx
xexülǰexü	xəxəlʤix
xegseixü	xəɡsiːx
xegsegenexü	xəɡsəɡnəx
xegselǰexü	xəɡsəlʤix
xegǰeixü	xəɡʤiːx
xegǰegürxexü	xəɡʤuːrxəx
xegǰelxü	xəɡʤləx
xegǰerexü	xəɡʤrəx
xegǰixü	xəɡʤix
xegenčirlexü	xəːnʧirləx
xegexü	xəːx
xegelexü	xəːləx
xegeltüxü	xəːltəx
xegeltügülxü	xəːltuːləx
xegesülexü	xəɡəːsləx
xegerelexü	xəːrləx
xemexü	xəməːx
xemegdexü	xəməːɡdəx
xemelixü	ximləx
xemisixü	ximʃix
xemirexü	ximrəx
xemnexü	xəmnəx
xemxelxü	xəmxələx
xemxečixü	xəmxəʧix
xemxerexü	xəmxərəx
xemxixü	ximxəx
xemǰixü	xəmʤix
xemǰiyelexü	xəmʤəːləx
xelexü	xələx
xelegeitüxü	xəlɡeːtəx
xelegeirexü	xəlɡeːrəx
xelegelǰexü	xəlɡəlʤix
xelemegeirxexü	xələmɡeːrxəx
xelemürčilexü	xəlmərʧləx
xelelexü	xəlləx
xelelčexü	xələlʧix
xelbeixü	xəlbiːx
xelbeigüdexü	xəlbiːɡuːdəx
xelbegenexü	xəlbəɡnəx
xelbegerdexü	xələbɡərdəx
xelbelǰexü	xəlbəlʤix
xelberixü	xələbrəx
xelberiǰixü	xəlbərʤix
xelberiǰigülxü	xəlbərʤuːləx
xelbixü	xəlbəx
xelbigürdexü	xəlbuːrdəx
xelxeixü	xəlxiːx
xelxegenexü	xəlxəɡnəx
xelxelǰexü	xəlxəlʤix
xelxixü	xilxəx
xelxildüxü	xilxəldəx
xelxiyelexü	xilxəːləx
xelxiyesülexü	xilxəːsləx
xelxiyerexü	xilxəːrəx
xelxiyereldüxü	xilxəːrəldəx
xelxirexü	xilxrəx
xelmexü	xəlməx~ɡəlməx
xelmegdexü	xəlməɡdəx~ɡəlməɡdəx
xelmegelǰexü	xələmɡəlʤix~ɡələmɡəlʤix
xelteixü	xəltiːx
xelteilgexü	xəltiːlɡəx
xeltegeilexü	xəltɡeːləx
xeltegeidexü	xəltɡeːdəx
xeltegenexü	xəltəɡnəx
xeltelxü	xəltləx
xeltelǰexü	xəltəlʤix
xeltečixü	xəltʧix
xelterexü	xəltrəx
xeltürixü	xəltrəx
xeltürigülxü	xəltruːləx
xeseglexü	xəsəɡləx
xesiglexü	xəʃiɡləx
xesüxü	xəsəx
xesügüčilexü	xəsuːʧləx
xetüidxü	xətiːdəx
xetürexü	xətrəx
xetüregülxü	xətruːləx
xetüremegeilexü	xətrəmɡeːləx
xetürxeilexü	xətərxeːləx
xetürxeidexü	xətərxeːdəx
xedegenetüxü	xədɡəntəx
xedegenerxexü	xədɡənərxəx
xederexü	xədrəx
xedergedexü	xədrəɡdəx
xederlexü	xədərləx
xedürxü	xədrəx
xečegüsiyexü	xəʧuːʃəːx
xečegüdexü	xəʧuːdəx
xečegüdxü	xəʧuːtəx
xečegürexü	xəʧuːrəx
xečegürxexü	xəʧuːrxəx
xečelexü	xəʧləx
xeǰixü	xəʤix
xeyegelexü	xəjəːləx
xeyegedexü	xəjəːdəx
xeyegerexü	xəjəːrəx
xeyelexü	xəjəːləx
xeyedexü	xəjəːdəx
xereglexü	xərəɡləx
xeregsexü	xərəɡsəx
xeregǰixü	xərəɡʤix
xeregǰigülxü	xərəɡʤuːləx
xeregelexü	xərəːləx
xereldüxü	xərəldəx
xereldügülxü	xərəlduːləx
xeresxelexü	xərsəɡləx
xeriglexü	xəriɡləx
xerüixü	xəriːx
xerüxü	xərəx
xerügesülexü	xərəːsləx
xerügedesülexü	xərəːdəsləx
xerbixü	xirbəx
xerxixü	xərxəx
xerseülexü	xərsuːləx
xerseüdexü	xərsuːdəx
xerčegeilexü	xərʧɡeːləx
xerčegeidexü	xərʧɡeːdəx
xerčixü	xərʧix
xerčiginexü	xərʧiɡnəx
xerčimlexü	xərʧimləx
xerčiyesülexü	xərʧəːsləx
xerǰeixü	xərʤiːx
xerǰegertüxü	xərʤɡərtəx
xinaxu	xɪnɑx
xinamagailaxu	xɪnɑmɡæːlɑx
xinamagaidaxu	xɪnɑmɡæːdɑx
xinamagairaxu	xɪnɑmɡæːrɑx
xinamǰilaxu	xɪnɑmʤlɑx
xinuxu	xɪnɑx
xinčeixü	xinʧiːx
xiŋxuulaxu	xɪŋxʊːlɑx
xiŋxuudaxu	xɪŋxʊːdɑx
xiŋgaradaxu	xɪŋɡɑrdɑx
xiŋginaxu	xɪŋɡɪnɑx
xibsixü	xibʃix
xixaxu	xɪxɑx
xixunaxu	xɪxnɑx
xixü	xiːx
xigursutuxu	xʊːrstɑx
ximagalaxu	xɪmɡɑlɑx
ximagadaxu	xɪmɡɑdɑx
ximusulaxu	xʊmslɑx
ximuraxu	xɪmrɑx
ximuralduxu	xɪmrɑldɑx
ximsaixu	xɪmsɪːx
ximsaganaxu	xɪmsɡɑnɑx
ximsalǰaxu	xɪmsɑlʤɪx
ximsadaxu	xɪmsɑːdɑx
ximdadxaxu	xɪmdɑtɡɑx
ximdadxu	xɪmdtɑx
ximdačilaxu	xɪmdʧɪlɑx
ximdaraxu	xɪmdrɑx
ximdaragulxu	xɪmdrʊːlɑx
xilaixu	xɪlɪːx
xilaŋgarlaxu	xɪlɑŋɡɑrlɑx
xilabalǰaxu	xɪlbɑlʤɪx
xilabxixü	xɪlɑbxiːx
xilagalaxu	xɪlɑːlɑx
xilamalǰaxu	xɪlmɑlʤɪx
xilamxixü	xɪlɑmxiːx
xiliŋnexü	xiləɡnəx
xiliŋlexü	xiləŋləx
xililexü	xilləx
xilisdexü	xilsdəx
xilisdegülxü	xilsduːləx
xiluixu	xɪlɪːx
xiluutuxu	xɪlʊːtɑx
xilubalǰaxu	xɪlbɑlʤɪx
xilumalǰaxu	xɪlmɑlʤɪx
xilbarsixu	xɪlbɑrʃɪx
xilbardaxu	xɪlbɑrdɑx
xilbarčilaxu	xɪlbɑrʧlɑx
xilbarǰixu	xɪlbɑrʤɪx
xilmaixu	xɪlmɪːx
xisaxu	xɪsɑx
xisxerxü	xisəɡrəx
xisxerdexü	xisɡərdəx
xitadčilaxu	xɪtɑdʧɪlɑx
xitarautuxu	xɪtrʊːtɑx
xitugalaxu	xʊtɡɑlɑx
xiduxu	xɪdɑx
xičiyeŋgüilexü	xiʧəːŋɡuiləx
xičiyexü	xiʧəːx
xičiyellexü	xiʧəːlləx
xiǰagalaxu	xɪʤɑːlɑx
xiǰagaraxu	xɪʤɑːrɑx
xiǰagarlaxu	xɪʤɡɑːrlɑx
xiǰalaxu	xɪʤɑːlɑx
xiyabalxu	xɪɑblɑx
xiyabaraxu	xɪɑbrɑx
xiyaglaxu	xɪɑɡlɑx
xiyačixu	xɪɑʧɪx
xiyaraxu	xɪɑrɑx
xiyarčiginaxu	xɪɑrʧɪɡnɑx
xiragalaxu	xɪrɑːlɑx
xiragudaxu	xɪrʊːdɑx
xiramalaxu	xɪrɑmlɑx
xiralaxu	xɪrlɑx
xirasagaxu	xɪrsɑːx
xiresxü	xirsəx
xirilexü	xirləx
xiruxu	xɪrɑx
xirugxu	xɪrɑx
xirögedexü	xoroːdox
xirbegesülexü	xirbəːsləx
xirgaxu	xɪrɡɑx
xirmaglaxu	xɪrmɑɡlɑx
xird'xixü	xirdxiːx
xirčiginexü	xirʧiɡnəx
xoinačaxu	xœːnʧɪx
xoigurdaxu	xœːɡʊːrdɑx
xoisilaxu	xœːʃlɔx
xoisilagulxu	xœːʃlʊːlɑx
xoisildaxu	xœːʃɪldɔx
xoisidaxu	xœːʃdɔx
xoisirxaxu	xœːʃɪrxɔx
xoirgolaxu	xœːrɡɔlɔx
xoirgosixu	xœːrɡɔʃɪx
xoirgodaxu	xœːrɡɔdɔx
xooxinaxu	xɔːxʲnɔx~xʊːxʲnɑx
xooxoilaxu	xɔːxœːlɔx
xooslaxu	xɔslɔx
xoorasixu	xɔrʃɪx
xooradaxu	xɔrdɔx
xooradagulxu	xɔrdʊːlɑx
xooraǰalaxu	xɔrʤlɔx
xoorlaxu	xɔrlɔx
xoorsixu	xɔrʃɪx
xoordaxu	xɔrdɔx
xoordagulxu	xɔrdʊːlɑx
xoniǰixu	xɔnʲʤɪx~xœnʤɪx
xonoxu	xɔnɔx
xonoglaxu	xɔnɔɡlɔx
xonogsixu	xɔnɔɡʃɪx
xontoxu	xɔntɔx
xondadaxu	xɔnddɔx
xonǰiŋnaxu	xɔnʤɪɡnɔx
xonǰixu	xɔnʤɪx
xonǰigdaxu	xɔnʤɪɡdɔx
xoŋxiixu	xœŋxɪːx
xoŋxilǰaxu	xœŋxɪlʤɪx
xoŋxoixu	xɔŋxɔɪx
xoŋxoilaxu	xɔŋxɔɪlɔx
xoŋxogonaxu	xɔŋxɡɔnɔx
xoŋxolǰaxu	xɔŋxɔlʤɪx
xoŋginaxu	xœŋɡɪnɔx
xoŋgildaxu	xœŋɡɪldɔx
xoŋgidaxu	xœŋɡɪdɔx
xoŋgodaxu	xɔŋɡɔdɔx
xoŋgorčoglaxu	xɔŋɡɔrʧɪɡlɔx
xoŋgorčogtoxu	xɔŋɡɔrʧɪɡtɔx
xoŋsiyardaxu	xɔŋʃɔːrdɔx
xobixinaxu	xœbxnɔx
xobixidaxu	xœbxdɔx
xobogodaxu	xɔbɔːdɔx
xobolosxu	xɔbɔlsɔx
xoborsixu	xɔbɔrʃɪx
xobordaxu	xɔbɔrdɔx
xoborǰixu	xɔbɔrʤɪx
xobxolxu	xɔbxlɔx
xobxočixu	xɔbxʧɪx
xobxoraxu	xɔbxrɔx
xoblaxu	xɔblɔx
xobsoraxu	xɔbsrɔx
xobtoxu	xɔbtɔx
xobdogorxaxu	xɔbdɡɔrxɔx
xobdoglaxu	xɔbdɔɡlɔx
xobdogsixu	xɔbdɔɡʃɪx
xobdolaxu	xɔbdlɔx
xobčilaxu	xɔbʧlɔx
xoxiixu	xœxɪːx
xoxibalǰaxu	xœxbɔlʤɪx
xoxiraxu	xœxrɔx
xoxiragulxu	xœxrʊːlɑx
xoxoilaxu	xɔxœːlɔx
xoxotonaxu	xɔxtnɔx
xogisolaxu	xœɡslɔx
xogoxolǰaxu	xɔːxɔlʤɪx
xogolalaxu	xɔːllɔx
xogosolaxu	xɔːslɔx
xogosodaxu	xɔːsdɔx
xogosoraxu	xɔːsrɔx
xogosoragulxu	xɔːsrʊːlɑx
xoglaxu	xɔɡlɔx
xoglagulxu	xɔɡlʊːlɑx
xogsixu	xɔɡʃɪx
xogǰirautuxu	xɔɡʤrʊːtɑx
xogǰiraxu	xɔɡʤrɔx
xomoixu	xɔmɔɪx
xomoilgaxu	xɔmɔɪlɡɔx
xomoxairaxu	xɔmxœːrɔx
xomoxairxaxu	xɔmxœːrxɔx
xomoxalǰaxu	xɔmxɔlʤɪx
xomorixu	xœmrɔx
xomorgalaxu	xɔmrɔɡlɔx
xomnoxu	xɔmnɔx
xomboixu	xɔmbɔɪx
xomxoixu	xɔmxɔɪx
xomxolxu	xɔmxɔlɔx
xomxoraxu	xɔmxɔrɔx
xomsadaxu	xɔmsdɔx
xomsadxaxu	xɔmsɔtɡɔx
xomsadxu	xɔmstɔx
xolasiyaxu	xɔlʃɔːx
xoladaxu	xɔldɔx
xoladxaxu	xɔltɡɔx
xoladxu	xɔltɔx
xolačilaxu	xɔlʧlɔx
xolixu	xœlɪx
xolimačaxu	xœlɪmʧɪx
xolilduxu	xœlɪldɔx
xoličaxu	xœlʧɪx
xoliyaxu	xœlɪɔx
xoliyalduxu	xœlɪɔldɔx
xolboxu	xɔlbɔx
xolbogalaxu	xɔlbɔːlɔx
xolbogulxu	xɔlbʊːlɑx
xolbogdaxu	xɔlbɔɡdɔx
xolboldoxu	xɔlbɔldɔx
xolborixu	xɔlɔbrɔx
xolxixu	xœlxɪx
xolxidaxu	xœlxdɔx
xolxoixu	xɔlxɔɪx
xolxogonaxu	xɔlxɡɔnɔx
xolxolǰaxu	xɔlxɔlʤɪx
xolgoxu	xɔlɡɔx
xolgogaxu	xɔlɡɔːx
xoltolxu	xɔltlɔx
xoltočixu	xɔltʧɪx
xoltorautuxu	xɔltrʊːtɑx
xoltoraxu	xɔltrɔx
xolčirxaituxu	xɔlʧɪrxœːtɔx
xolčirlaxu	xɔlʧɪrlɔx
xolčorautuxu	xɔlʧrʊːtɑx
xosixu	xɔʃɪx
xosigulaxu	xɔʃʊːlɑx~xʊʃʊːlɑx
xosiguldaxu	xɔʃʊːldɑx~xʊʃʊːldɑx
xosigučilaxu	xɔʃʊːʧlɑx~xʊʃʊːʧlɑx
xosiguraxu	xɔʃʊːrɑx~xʊʃʊːrɑx
xosilaxu	xɔʃlɔx
xosxičixu	xɔʃɪɡʧɪx
xosxirxu	xɔʃɪɡrɔx
xošoŋnaxu	xɔʃɪɡnɔx
xošoŋčilaxu	xɔʃɪŋʧlɔx
xošuuraxu	xɔʃʊːrɑx~xʊʃʊːrɑx
xotalaxu	xɔtlɔx
xotoixu	xɔtɔɪx
xotogonaxu	xɔtɡɔnɔx
xotolǰaxu	xɔtɔlʤɪx
xodogočixu	xɔdɡɔʧɪx
xočilaxu	xɔʧlɔx
xočorogdaxu	xɔʧrɔɡdɔx
xočorxu	xɔʧrɔx
xočorgaxu	xɔʧrɔːx
xoǰiixu	xɔʤɪːx
xoǰixu	xɔʤɪx
xoǰigirtoxu	xɔʤɡɪrtɔx
xoǰigudaxu	xɔʤʊːdɑx
xoǰigdaxu	xɔʤɪɡdɔx
xoǰimdaxu	xɔʤɪmdɔx
xoǰidaxu	xɔʤdɔx
xoyarlaxu	xɔjɪrlɔx
xoyardaxu	xɔjɪrdɔx
xorixu	xœrɪx
xoriglaxu	xœrɪɡlɔx
xorigdaxu	xœrɪɡdɔx
xoroxailaxu	xɔrxœːlɔx
xoroxaisixu	xɔrxœːʃɪx
xoroxaisxu	xɔrxœːsɔx
xoroxaituxu	xɔrxœːtɔx
xoroxu	xɔrɔx
xorogaxu	xɔrɔːx
xorogalaxu	xɔrɔːlɔx
xorogolǰaxu	xɔrɡɔlʤɪx
xorogdaxu	xɔrɔɡdɔx
xorogdagulxu	xɔrɔɡdʊːlɑx
xorolaxu	xɔrlɔx
xorosxaxu	xɔrsɡɔx
xorosxu	xɔrsɔx
xorodaxu	xɔrdɔx
xorboixu	xɔrbɔɪx
xorxixü	xɔrxiːx
xorxoixu	xɔrxɔɪx
xorxoglaxu	xɔrxɔɡlɔx
xorgoxu	xɔrɡɔx
xorgogoxu	xɔrɡɔːx
xorgomčilaxu	xɔrɡɔmʧlɔx
xorgolaxu	xɔrɡɔlɔx
xorgodaxu	xɔrɡɔdɔx
xorgočaxu	xɔrɡɔʧɪx
xorgočagaxu	xɔrɡɔʧɔːx
xorgusulaxu	xɔrɡʊːslɑx
xormoilaxu	xɔrmœːlɔx
xormoidaxu	xɔrmœːdɔx
xorsixu	xɔrʃɪx
xorsiyalaxu	xɔrʃɔːlɔx
xorsiyaǰixu	xɔrʃɔːʤɪx
xorsiyaǰigulxu	xɔrʃɔːʤʊːlɑx
xorčiixu	xɔrʧɪːx
xorčiginaxu	xɔrʧɪɡnɔx
xorčigirtoxu	xɔrʧɡɪrtɔx
xorčigirdaxu	xɔrʧɡɪrdɔx
xorčilǰaxu	xɔrʧɪlʤɪx
xorǰiginaxu	xɔrʤɪɡnɔx
xuibilaxu	xʊɪblɑx
xuixalaxu	xʊɪxlɑx
xuixulǰaxu	xʊɪxɑlʤɪx
xuixurlaxu	xʊɪxɑrlɑx
xuixurdaxu	xʊɪxɑrdɑx
xuilaxu	xʊɪlɑx
xuilaraxu	xʊɪlrɑx
xuisaganaxu	xʊɪsɡɑnɑx
xuisalǰaxu	xʊɪsɑlʤɪx
xuisaraxu	xʊɪsrɑx
xuiraxu	xʊɪrɑx
xuubilduxu	xʊɪbɑldɑx
xuuxinaxu	xʊːxʲnɑx
xuuxinatuxu	xʊːxɪntɑx
xuuxirxu	xʊːxʲrɑx
xuugixu	xʊːɡɪx
xuusatuxu	xʊːstɑx
xuuduulaxu	xʊːdʊːlɑx
xuuduuraxu	xʊːdʊːrɑx
xuurgalaxu	xʊːrɡɑlɑx
xunixu	xʊnɪx
xuniyasulaxu	xʊnɪɑslɑx
xuniyasutuxu	xʊnɪɑstɑx
xunirixu	xʊnʲrɑx
xuniriyatuxu	xʊnʲrɑːtɑx
xundagalaxu	xʊndɡɑlɑx
xuŋgarlaxu	xʊŋɡɑrlɑx
xuŋsiguraxu	xʊŋʃʊːrɑx
xubaxairaxu	xʊbxæːrɑx
xubinčilaxu	xʏbɪnʧlɑx~xœbɪnʧlɔx
xubilaxu	xʏblɑx~xœblɔx
xubilxu	xʏblɑx~xœblɔx
xubilgaxu	xʏbɪlɡɑx~xœbɪlɡɔx
xubisxaxu	xʏbsɡɑx~xœbsɡɔx
xubisxalǰixu	xʏbsɡɑlʤɪx~xœbsɡɔlʤɪx
xubisxalǰigulxu	xʏbsɡɑlʤʊːlɑx~xœbsɡɔlʤʊːlɑx
xubisxu	xʏbsɑx~xœbsɔx
xubiyaxu	xʊbɑːx
xubiyagdaxu	xʊbɑːɡdɑx
xubiyalaxu	xʊbɑːlɑx
xubiyarilaxu	xʊbɑːrlɑx
xubiraxu	xʏbrɑx~xœbrɔx
xubiragulxu	xʏbrʊːlɑx~xœbrʊːlɑx
xubirxaxu	xʏbɪrxɑx~xœbɪrxɔx
xubčalaxu	xʊbʧlɑx
xubčasulaxu	xʊbʧɪslɑx
xubčasuǰixu	xʊbʧɪsʤɪx
xugunixu	xʊːnɪx
xugulxu	xʊɡlɑx
xugučaxu	xʊɡʧɪx
xugučagalaxu	xʊɡʧɑːlɑx
xugučixu	xʊɡʧɪx
xuguraxu	xʊɡrɑx
xugurdaxu	xʊːrdɑx
xumixu	xʏmɪx
xumiraxu	xʏmrɑx
xumusulaxu	xʊmslɑx
xumbaixu	xʊmbɪːx
xumbixu	xʏmbɑx
xumxixu	xʏmxɪx
xulagailaxu	xʊlɡæːlɑx
xulaguxu	xʊlʊːx
xuluixu	xʊlɪːx
xuluutuxu	xʊlʊːtɑx
xulugubčilaxu	xʊlɡɑbʧlɑx
xulugutuxu	xʊlɡɑtɑx
xululǰaxu	xʊlɑlʤɪx
xulxaxu	xʊlxɑx
xulxituxu	xʏlxtɑx
xulmaixu	xʊlmɪːx
xulmaganaxu	xʊlɑmɡɑnɑx
xulmalǰaxu	xʊlmɑlʤɪx
xultuganaxu	xʊltɡɑnɑx
xultugčixu	xʊltɑɡʧɪx
xuldaxu	xʊldɑx
xuldagasulaxu	xʊldɑːslɑx
xulčiixu	xʊlʧɪːx
xulčiganaxu	xʊlʧɡɑnɑx
xulčilǰaxu	xʊlʧɪlʤɪx
xulǰixu	xʊlʤɪx
xusaraŋtuxu	xʊsrɑŋtɑx
xusaraxu	xʊsrɑx
xusigalaxu	xʊʃɡɑlɑx
xusuxu	xʊsɑx
xusugurdaxu	xʊsʊːrdɑx
xusumtuxu	xʊsɑmtɑx
xudalduxu	xʊdɑldɑx
xudaldugalaxu	xʊdɑldɑːlɑx
xudargalaxu	xʊdrɑɡlɑx
xudxuxu	xʊtɡɑx
xudxumsilaxu	xʊtɡɑmʃlɑx
xudxulaxu	xʊtɡɑlɑx
xudxulduxu	xʊtɡɑldɑx
xudxuldugulxu	xʊtɡɑldʊːlɑx
xudxuraxu	xʊtɡɑrɑx
xudxuragulxu	xʊtɡɑrʊːlɑx
xučaxu	xʊʧɪx
xučixu	xʊʧɪx
xučilgalaxu	xʊʧlɑɡlɑx
xučuulxu	xʊʧʊːlɑx
xuǰiixu	xʊʤɪːx
xuǰigardaxu	xʊʤɡɑrdɑx
xuǰiginaxu	xʊʤɪɡnɑx
xuǰirlaxu	xʊʤɪrlɑx
xuǰirsaxu	xʊʤɪrsɑx
xuǰirsixu	xʊʤɪrʃɪx
xuǰirtuxu	xʊʤɪrtɑx
xuyaŋtuxu	xʊjɪŋtɑx
xuyaglaxu	xʊjɪɡlɑx
xuyalituxu	xʊjɪltɑx
xuraxu	xʊrɑx
xuragalaxu	xʊrɡɑlɑx
xuramduxu	xʊrɑmdɑx
xuramdugulxu	xʊrɑmdʊːlɑx
xuramdulaxu	xʊrɑmdlɑx
xuralduxu	xʊrɑldɑx
xuraldugulxu	xʊrɑldʊːlɑx
xurasixu	xʊrʃɪx
xurimlaxu	xʏrɪmlɑx
xuričaxu	xʏrʧɪx
xuriyaŋguilaxu	xʊrɑːŋɡʊɪlɑx
xuriyaxu	xʊrɑːx
xuriyamǰilaxu	xʊrɑːmʤlɑx
xuruilaxu	xʊræːlɑx
xuruilǰaxu	xʊræːlʤɪx
xurulǰaxu	xʊrɑlʤɪx
xurxaglaxu	xʊrxɑɡlɑx
xurxiraxu	xʏrxrɑx
xurlaxu	xʊrlɑx
xurlagulxu	xʊrlʊːlɑx
xursixu	xʊrʃɪx
xursigaxu	xʊrʃɑːx
xurdubčilaxu	xʊrdɑbʧlɑx
xurdulaxu	xʊrdlɑx
xurdusxu	xʊrdsɑx
xurdudxaxu	xʊrdɑtɡɑx
xurdudxu	xʊrdtɑx
xurčalaxu	xʊrʧlɑx
xurčadxaxu	xʊrʧɪtɡɑx
xurčadxu	xʊrʧtɑx
xurčiginaxu	xʊrʧɪɡnɑx
xurǰiixu	xʊrʤɪːx
xurǰiilgaxu	xʊrʤɪːlɡɑx
xuwalaixu	xʊɑlɪːx
xuwalaxu	xʊɑlɑx
xuwarlaxu	xʊɑrlɑx
xööglexü	xoːɡlox
xönögexü	xonoːx
xöntöixü	xontoix
xöntöilgexü	xontoilɡox
xöntörxü	xontrox
xöntörgedexü	xontroɡdox
xöndeilexü	xondoilox
xöndeidexü	xondoidox
xöndeirexü	xondoirox
xöndeiregülxü	xondoiruːləx
xöndexü	xondox
xöndegürlexü	xonduːrləx
xöndelesxü	xondolsox
xöndelidxü	xondoldox
xöŋxöixü	xoŋxoix
xöŋgebčilexü	xoŋɡobʧlox
xöŋgemsüglexü	xoŋɡomsoɡlox
xöŋgelexü	xoŋɡolox
xöŋgedexü	xoŋɡodox
xöŋgedxexü	xoŋɡotɡox
xöŋgedxü	xoŋɡotox
xöŋgeǰixü	xoŋɡoʤix
xöŋgeǰigülxü	xoŋɡoʤuːləx
xöŋgerexü	xoŋɡorox
xöŋgeregülxü	xoŋɡoruːləx
xöŋgertüxü	xoŋɡortox
xöbegelexü	xoboːlox
xöbegedexü	xoboːdox
xöbegüčilexü	xobuːʧləx~xobɡuːʧləx
xöböixü	xoboix
xöböxirexü	xobxrox
xöböxü	xobox
xöbögülxü	xobuːləx
xöbölǰexü	xobolʤix
xöbörexü	xobrox
xöböridxü	xobordox
xöbbögülxü	xobuːləx
xöbxeixü	xobxoix
xöbxexü	xobxox
xöbxegenexü	xobxoɡnox
xöbxelǰexü	xobxolʤix
xöbxixü	xobxiːx
xöbxixü	xobxox
xöbxü	xobox
xöbsöixü	xobsoix
xöbsögenexü	xobsoɡnox
xöbsölǰexü	xobsolʤix
xöbsörxü	xobsrox
xöbsördexü	xobsordox
xöbčilexü	xobʧlox
xöbčidexü	xobʧdox
xöxerentüxü	xoxrontox
xöxerexü	xoxrox
xöxixü	xoxox
xöxigexü	xoxoːx
xöxigülxü	xoxuːləx
xöxirexü	xoxrox
xöxöxü	xoxox
xöxögülxü	xoxuːləx
xöxörexü	xoxrox
xöglexü	xoɡlox
xöglegülxü	xoɡluːləx
xöglerexü	xoɡlorox
xögseixü	xoɡsoix
xögsexü	xoɡsox
xögsegexü	xoɡsoːx
xögsidexü	xoɡʃdox
xögsirexü	xoɡʃrox
xögǰixü	xoɡʤix
xögǰigexü	xoɡʤoːx
xögǰigülxü	xoɡʤuːləx
xögǰimdexü	xoɡʤimdox
xögenexü	xoɡnox
xögeŋgitüxü	xoːŋɡotox
xögeŋgirexü	xoːŋɡorox
xögebürlexü	xoːborlox
xögegexü	xoːx
xögegelgexü	xoːlɡox
xögegelčexü	xoːlʧix
xögegečeldüxü	xoːʧildox
xögesülexü	xoːslox
xögesütüxü	xoːstox
xögesürexü	xoːsrox
xögečürexü	xoɡʧrox
xögerüxüilexü	xoːrxoilox
xögerügülxü	xoːruːləx
xögerüldüxü	xoːroldox
xögerxü	xoːrox
xögergexü	xoːrɡox
xögergedexü	xoːroɡdox
xömeilexü	xoːmøːlox
xömöixü	xomoix
xömöldörgelexü	xomoldroɡlox
xömörixü	xomrox
xömörigülxü	xomruːləx
xömörgelexü	xomroɡlox
xömünčilexü	xunʧləx~xumuːnʧləx
xömüǰixü	xumuːʤix
xömüǰigülxü	xumuːʤuːləx
xölexü	xoːlox
xölösölexü	xolslox
xölörexü	xolrox
xölöregexü	xolroːx
xölöregülxü	xolruːləx
xölberixü	xolobrox
xölxixü	xolxox
xölxitüxü	xolxtox
xölxü	xolox
xölgelexü	xoloɡlox
xölmöixü	xolmoix
xölmögenexü	xolmoɡnox
xölmögerdexü	xolomɡordox
xölmölǰexü	xolmolʤix
xöllexü	xollox
xölsexü	xolsox
xöltörgelexü	xoltroɡlox
xöldexü	xoldox
xöldegexü	xoldoːx
xölčixü	xolʧix
xölčöxü	xolʧix
xölčögexü	xolʧoːx
xölčögürexü	xolʧuːrəx
xölčögürxexü	xolʧuːrxəx
xösersixü	xosorʃix
xöserdexü	xosordox
xöserdegülxü	xosorduːləx
xösixü	xoʃix
xösigexü	xoʃoːx
xösigelexü	xoʃiɡlox
xösigüdexü	xoʃuːdəx
xösigüdxü	xoʃuːtəx
xösigürexü	xoʃuːrəx
xösigürxexü	xoʃuːrxəx
xösigürgelexü	xoʃuːrəɡləx
xösigürgedexü	xoʃuːrəɡdəx
xösigürlexü	xoʃuːrləx
xösigürdexü	xoʃuːrdəx
xösiyelexü	xoʃoːlox
xösxölexü	xoʃiɡlox
xötöxü	xoːtox
xötölbörilexü	xotolborlox
xötölxü	xotlox
xötölčexü	xotolʧix
xödexü	xoːdox
xödegelexü	xodoːlox
xödegelegülxü	xodoːluːləx
xödelüsxixü	xodlosxiːx
xödelxü	xodlox
xödelgexü	xodolɡox
xödelmürilexü	xodolmorlox
xödelmüriǰixü	xodolmorʤix
xödelmüriǰigülxü	xodolmorʤuːləx
xöčilexü	xoːʧlox
xöǰördexü	xoʤirdox
xöyögelexü	xojoːlox
xöröŋgelexü	xoroŋɡolox
xöröŋgesixü	xoroŋɡoʃix
xöröŋgetenčilexü	xoroŋɡotonʧlox
xöröŋgeǰixü	xoroŋɡoʤix
xöröbeǰixü	xorobʤix
xöröxü	xorox
xöröglexü	xoroɡlox
xörögexü	xorɡox~xoroːx
xörösölexü	xorslox
xörösöǰixü	xorsʤix
xörbexü	xorbox
xörbegülxü	xorbuːləx
xörböxü	xorbox
xörlexü	xorlox
xörsiyexü	xoːrʃoːx
xörtöxü	xortox
xördexü	xoːrdox
xördöxü	xordox
xörǰeixü	xorʤiːx
xörǰeŋtüxü	xorʤiŋtox
xüigüxü	xuiɡəx
xüigüldüxü	xuiɡəldəx
xüilexü	xuiləx
xüitentüxü	xuitəntəx
xüitedexü	xuitdəx
xüiterexü	xuitrəx
xüidxü	xuidəx
xüülexü	xuːləx
xüüčilexü	xuːʧləx
xüürnixü	xuːrnəx
xünesülexü	xunsləx
xündülexü	xundləx
xündüsiyexü	xundʃəːx
xündüdexü	xunddəx
xündüdxexü	xundətɡəx
xündüdxü	xundtəx
xündürexü	xundrəx
xüŋxüixü	xuŋxiːx
xüŋxüxü	xuŋxəx
xüŋginexü	xuŋɡənəx
xüŋgirsexü	xuŋɡərsəx
xüberxü	xubrəx
xübürexü	xubrəx
xübürlexü	xubərləx
xüxütünexü	xuxtnəx
xügdüixü	xuɡdiːx
xügdügenexü	xuɡdəɡnəx
xügdülǰexü	xuɡdəlʤix
xülixü	xulix
xüligelǰexü	xulɡəlʤix
xüličexü	xulʧix
xüliyexü	xuliəx
xüliyesülexü	xuliəsləx
xülxüixü	xulxiːx
xülxüxü	xulxəx
xülxügenexü	xulxəɡnəx
xülxügerdexü	xulxɡərdəx
xülxülǰexü	xulxəlʤix
xültüixü	xultiːx
xültügenexü	xultəɡnəx
xüsexü	xusəx
xüsegürxexü	xusuːrxəx
xüsünügčilexü	xusnəɡʧləx
xüsünügǰigülxü	xusnəɡʤuːləx
xüdeŋtüxü	xudəŋtəx
xüdebürdexü	xudbərdəx
xüdegilexü	xudəɡləx
xüdegidexü	xudəɡdəx
xüdesxü	xudsəx
xüčiltüxü	xuʧiltəx
xüčirdexü	xuʧirdəx
xüčirdegülxü	xuʧirduːləx
xüčülexü	xuʧləx
xüčürexü	xuʧrəx
xüčürxexü	xuʧirxəx
xüčürxeglexü	xuʧirxəɡləx
xüčürxegǰixü	xuʧirxəɡʤix
xüǰügüdexü	xuʤuːdəx
xüreixü	xuriːx
xüreŋnexü	xurəɡnəx
xüreŋtüxü	xurəŋtəx
xüritüxü	xurtəx
xüridlexü	xurdləx
xüriyelexü	xurəːləx
xüriyelegdexü	xurəːləɡdəx
xürülčexü	xurəlʧix
xürülčegülxü	xurəlʧuːləx
xürxixü	xurxiːx
xürxirexü	xurxrəx
xürxiretüxü	xurxrəːtəx
xürxü	xurəx
xürgexü	xurɡəx
xürgelexü	xurɡələx
xürtexü	xurtəx
xürtegexü	xurtəːx
xürdülexü	xurdləx
xürčiginexü	xurʧiɡnəx
xürǰedexü	xurʤdəx
gxiblexü	xibləx
gxirtüxü	xirtəx
gxirtügexü	xirtəːx
gaixaxu	ɡæːxɑx
gaixagulxu	ɡæːxʊːlɑx
gaixasxixü	ɡæːxɑsxiːx
gailaxu	ɡæːlɑx
gaililaxu	ɡæːllɑx
gaituxu	ɡæːtɑx
ganaixu	ɡɑnɪːx
ganabalǰaxu	ɡɑnbɑlʤɪx
ganalǰaxu	ɡɑnɑlʤɪx
ganixaraxu	ɡænɪxrɑx
ganixu	ɡænɪx
ganiraxu	ɡænrɑx
gandaixu	ɡɑndɪːx
gandaguraxu	ɡɑndʊːrɑx
gandalǰaxu	ɡɑndɑlʤɪx
ganǰugalaxu	ɡɑnʤɡɑlɑx
gaŋnaxu	ɡɑɡnɑx
gaŋxuxu	ɡɑŋxɑx
gaŋxulǰaxu	ɡɑŋxɑlʤɪx
gaŋganaxu	ɡɑŋɡɑnɑx
gaŋganalduxu	ɡɑŋɡɑnɑldɑx
gaŋgamsuglaxu	ɡɑŋɡɑmsɑɡlɑx
gaŋgalaxu	ɡɑŋɡɑlɑx
gaŋginaxu	ɡæŋɡɪnɑx
gaŋsaraxu	ɡɑŋsrɑx
gaŋsixu	ɡɑŋʃɪx
gaŋtuxu	ɡɑŋtɑx
gaŋdaxu	ɡɑŋdɑx
gabalaxu	ɡɑblɑx
gabatuxu	ɡɑbtɑx
gabixu	ɡæbɪx
gabiyalaxu	ɡɑbjɑːlɑx
gabiyadaxu	ɡɑbjɑːdɑx
gabiyarxaxu	ɡɑbjɑːrxɑx
gabsigailaxu	ɡɑbʃɡæːlɑx
gaxaituxu	ɡɑxæːtɑx
gagaglaxu	ɡɑːɡlɑx
gagaraxu	ɡɑːrɑx
gaguixu	ɡɑɡɪːx
gagulǰaxu	ɡɑɡɑlʤɪx
gagčagarlaxu	ɡɑnʧɑːrlɑx~ɡɑɡʧɑːrlɑx
gagčagardaxu	ɡɑnʧɑːrdɑx~ɡɑɡʧɑːrdɑx
gagčagardagulxu	ɡɑnʧɑːrdʊːlɑx~ɡɑɡʧɑːrdʊːlɑx
gagčalaxu	ɡɑnʧlɑx~ɡɑɡʧlɑx
gagčadaxu	ɡɑnʧdɑx~ɡɑɡʧdɑx
gamnaxu	ɡɑmnɑx
gamsigdaxu	ɡɑmʃɪɡdɑx
gamǰiŋdaxu	ɡɑnʤɪŋdɑx~ɡɑmʤɪŋdɑx
galixaraxu	ɡælɪxrɑx
galixu	ɡælɪx
galiglaxu	ɡælɪɡlɑx
galigčilaxu	ɡælɪɡʧlɑx
galiraxu	ɡælrɑx
galirasxixü	ɡælrɑsxiːx
galgixu	ɡælɡɪx
galgigulxu	ɡælɡɪʊlɑx
gallaxu	ɡɑllɑx
galdaxu	ɡɑldɑx
galǰaguraxu	ɡɑlʤʊːrɑx
galǰirtuxu	ɡɑlʤɪrtɑx
gasaŋdaxu	ɡɑsɑŋdɑx
gasalxu	ɡɑslɑx
gasalgaxu	ɡɑsɑlɡɑx
gasigudaxu	ɡɑʃʊːdɑx
gasilxu	ɡɑʃlɑx
gasilgaxu	ɡɑʃɪlɡɑx
gatulxu	ɡɑtlɑx
gadaixu	ɡɪdɪːx
gadabalǰaxu	ɡɪdbɑlʤɪx
gadaxu	ɡɑdɑx
gadagalaxu	ɡɑdɑːlɑx
gadagurxaxu	ɡɑdʊːrxɑx
gadagurlaxu	ɡɑdʊːrlɑx
gadagursiyaxu	ɡɑdʊːrʃɑːx
gadagurčilaxu	ɡɑdʊːrʧlɑx
gadagsilaxu	ɡɑdɑɡʃlɑx
gadasulaxu	ɡɑdɑslɑx
gadasudaxu	ɡɑdɑsdɑx
gadarixu	ɡædrɑx
gadarlaxu	ɡɑdɑrlɑx
gačaxu	ɡɑʧɪx
gačagdaxu	ɡɑʧɪɡdɑx
gačixu	ɡɑʧɪx
gačigdaxu	ɡɑʧɪɡdɑx
gačigdagulxu	ɡɑʧɪɡdʊːlɑx
gačiyadaxu	ɡɑʧɑːdɑx
gačugalaxu	ɡɑʧɑːlɑx
gaǰarlaxu	ɡɑʤɪrlɑx
gaǰarsixu	ɡɑʤɪrʃɪx
gaǰardaxu	ɡɑʤɪrdɑx
gaǰarčilaxu	ɡɑʤɪrʧlɑx
gaǰixu	ɡɑʤɪx
gaǰigaxu	ɡɑʤɑːx
gaǰigudaxu	ɡɑʤʊːdɑx
gaǰigudagulxu	ɡɑʤʊːdʊːlɑx
gaǰigurxaxu	ɡɑʤʊːrxɑx
garaŋgatuxu	ɡɑrɑŋɡɑtɑx
garaxalaxu	ɡɑrxlɑx
garaxatuxu	ɡɑrxtɑx
garuǰadaxu	ɡɑrʤdɑx
garxu	ɡɑrɑx
gargaxu	ɡɑrɡɑx
garmagailaxu	ɡɑrɑmɡæːlɑx
garlaxu	ɡɑrlɑx
garsixu	ɡɑrʃɪx
gartaxu	ɡɑrtɑx
gartagaxu	ɡɑrtɑːx
gardaxu	ɡɑrdɑx
gardagulxu	ɡɑrdʊːlɑx
garčaglaxu	ɡɑrʧɪɡlɑx
garǰaixu	ɡɑrʤɪːx
geixü	ɡiːx
geigenčirlexü	ɡiːɡənʧirləx
geigexü	ɡiːɡəx
geigülxü	ɡiːɡuːləx
geičilexü	ɡiːʧləx
geičirxexü	ɡiːʧirxəx
geirexü	ɡiːrəx
genedexü	ɡəndəx
genedegdexü	ɡəndəɡdəx
genedegülxü	ɡənduːləx
generexü	ɡənrəx
geŋxerexü	ɡəŋxrəx
geŋgüxü	ɡəŋɡəx
geŋserexü	ɡəŋsrəx
gexiixü	ɡəxiːx
gexixü	ɡəxəx
gexilǰexü	ɡəxəlʤix
gexü	ɡəx
gegdexü	ɡəɡdəx
gegexü	ɡəːx
gegegdexü	ɡəːɡdəx
gegerexü	ɡəɡəːrəx
gegeregülxü	ɡəɡəːruːləx
gegeresxixü	ɡəɡəːrəsxiːx
gemürxü	ɡəmrəx
gemnexü	ɡəmnəx
gemsixü	ɡəmʃix
gemtüxü	ɡəmtəx
gemtügexü	ɡəmtəːx
gelixü	ɡiləx
geldürixilexü	ɡəldərxiːləx
geldürixü	ɡəldrəx
gelčexü	ɡəlʧix
gesxexü	ɡəsɡəx
gesxü	ɡəsəx
getexü	ɡətəx
getelxilexü	ɡətəlxiːləx
getülxü	ɡətləx
getülgexü	ɡətəlɡəx
gedeixü	ɡədiːx
gedebelǰexü	ɡədbəlʤix
gedegenexü	ɡədəɡnəx
gedegelexü	ɡədəɡləx
gedelǰexü	ɡədəlʤix
gedesxixü	ɡədəsxiːx
gedergülexü	ɡədrəɡləx
gedergüdexü	ɡədrəɡdəx
geǰigelexü	ɡəʤiɡləx
geǰigedexü	ɡəʤiɡdəx
geyürexü	ɡəjuːrəx
gereltüxü	ɡərəltəx
gereltügülxü	ɡərəltuːləx
gereldexü	ɡərəldəx
geredexü	ɡərəːdəx
gerečilexü	ɡərʧləx
geriyesülexü	ɡərəːsləx
geriyeslexü	ɡərəːsləx
gerlexü	ɡərləx
ginǰilexü	ɡinʤləx
giŋginexü	ɡiŋɡənəx
giŋsixü	ɡiŋʃix
gilaixu	ɡɪlɪːx
gilailgaxu	ɡɪlɪːlɡɑx
gilabalǰaxu	ɡɪlbɑlʤɪx
gilaganaxu	ɡɪlɡɑnɑx
gilalǰaxu	ɡɪlɑlʤɪx
gilasxu	ɡɪlsɑx
giluixu	ɡɪlɪːx
gilüixü	ɡiliːx
gilübelǰexü	ɡilbəlʤix
gilügenexü	ɡiləɡnəx
gilülǰexü	ɡiləlʤix
gilürexü	ɡilrəx
gilbaixu	ɡɪlbɪːx
gilbaxu	ɡɪlbɑx
gilbaganaxu	ɡɪlɑbɡɑnɑx
gilbagulxu	ɡɪlbʊːlɑx
gilbalǰaxu	ɡɪlbɑlʤɪx
gilbelǰexü	ɡilbəlʤix
gilbigenexü	ɡilbəɡnəx
gilgürixü	ɡilɡərəx
giltaixu	ɡɪltɪːx
giltaganaxu	ɡɪltɡɑnɑx
giltügenexü	ɡiltəɡnəx
gilǰiixü	ɡilʤiːx
gilǰiilgexü	ɡilʤiːlɡəx
gilǰigenexü	ɡilʤiɡnəx
gilǰilǰexü	ɡilʤilʤix
gisxinaxu	ɡɪʃɪɡnɑx
gisxixü	ɡiʃɡəx
gisxilexü	ɡiʃiɡləx
gičilexü	ɡiʧləx
giraxaisixu	ɡɪrxæːʃɪx
girbisixü	ɡirəbʃix
girbidexü	ɡirəbdəx
girbiyetüxü	ɡirbəːtəx
goigorxu	ɡœːɡɔrɔx
goidalaxu	ɡœːdlɔx
goiraxu	ɡœːrɔx
goonoixu	ɡɔːnɔɪx
goomailaxu	ɡɔːmœːlɔx
goomaituxu	ɡɔːmœːtɔx
goomaidaxu	ɡɔːmœːdɔx
goomairaxu	ɡɔːmœːrɔx
goollaxu	ɡɔllɔx
goolsaxu	ɡɔlsɔx
gooltoxu	ɡɔltɔx
gooldaxu	ɡɔldɔx
goolčilaxu	ɡɔlʧlɔx
gootuudaxu	ɡɔːtʊːdɑx
goodaxu	ɡɔːdɔx
goočilaxu	ɡɔːʧlɔx
gontoxu	ɡɔntɔx
gonǰiixu	ɡɔnʤɪːx
gonǰiganaxu	ɡɔnʤɡɔnɔx
gonǰilǰaxu	ɡɔnʤɪlʤɪx
gonǰoixu	ɡɔnʤɪːx
gonǰogordaxu	ɡɔnʤɡɔrdɔx
goŋsoixu	ɡɔŋsɔɪx
goŋsoraxu	ɡɔŋsrɔx
gobixu	ɡœbɪx
gobiltoxu	ɡœbɪltɔx
gobildaxu	ɡœbɪldɔx
gobogonaxu	ɡɔbɡɔnɔx
goxalaxu	ɡɔxlɔx
goxadaxu	ɡɔxdɔx
goxadagdaxu	ɡɔxdɔɡdɔx
goxiixu	ɡœxɪːx
goxilǰaxu	ɡœxɪlʤɪx
gogodaxu	ɡɔɡdɔx~ɡɔɡɔːdɔx
gogoǰixu	ɡɔːʤɪx
gogoǰigulxu	ɡɔːʤʊːlɑx
gogorxaxu	ɡɔːrxɔx
gogčogalaxu	ɡɔɡʧɔːlɔx
gogčogaldaxu	ɡɔɡʧɔːldɔx
gogčogadaxu	ɡɔɡʧɔːdɔx
gogčogaraxu	ɡɔɡʧɔːrɔx
gomodaxu	ɡɔmdɔx
gomodagaxu	ɡɔmdɔːx
gomorxaxu	ɡɔmɔrxɔx
gomorxu	ɡɔmrɔx
goliixu	ɡœlɪːx
golilǰaxu	ɡœlɪlʤɪx
goloxu	ɡɔlɔx
golomdaxu	ɡɔlɔmdɔx
gosoixu	ɡɔsɔɪx
gosomdaxu	ɡɔsɔmdɔx
godoixu	ɡɔdɔɪx
godoŋtoxu	ɡɔdɔŋtɔx
godobalǰaxu	ɡɔdbɔlʤɪx
godoxu	ɡɔdɔx
godogoilaxu	ɡɔdɡœːlɔx
godogonaxu	ɡɔdɡɔnɔx
godolidxu	ɡœdɪldɔx
godolǰaxu	ɡɔdɔlʤɪx
godoroŋtoxu	ɡɔdrɔŋtɔx
godlaxu	ɡɔdlɔx
gočolaxu	ɡɔʧlɔx
goǰiixu	ɡɔʤɪːx
goǰiginaxu	ɡɔʤɪɡnɔx
goǰilǰaxu	ɡɔʤɪlʤɪx
goǰoixu	ɡɔʤɪːx
goǰoilgaxu	ɡɔʤɪːlɡɔx
goǰogonaxu	ɡɔʤɡɔnɔx
goǰolǰaxu	ɡɔʤɪlʤɪx
goyačilaxu	ɡɔjʧlɔx~ɡʊjʧlɔx
goyoxu	ɡɔjɪx
goyomsoglaxu	ɡɔjɪmsɔɡlɔx
goyolaxu	ɡɔjlɔx
goyolxilaxu	ɡɔjɪlxiːləx
goyotoxu	ɡɔjtɔx
gorimlaxu	ɡœrɪmlɔx
gorilaxu	ɡœrlɔx
goridaxu	ɡœrdɔx
goroixu	ɡɔrɔɪx
goroxalaxu	ɡɔrxlɔx
gorgilaxu	ɡœrɪɡlɔx
gorgidaxu	ɡœrɪɡdɔx
gortiglaxu	ɡœrtɔɡlɔx
gortigdaxu	ɡœrtɔɡdɔx
gortoxu	ɡɔrtɔx
gordoixu	ɡɔrdɔɪx
gorǰoixu	ɡɔrʤɪːx
guibixu	ɡʊɪbɑx
guibiganaxu	ɡʊɪbɡɑnɑx
guibigulxu	ɡʊɪbʊːlɑx
guibilǰaxu	ɡʊɪbɑlʤɪx
guilinčilaxu	ɡʊɪlɑnʧlɑx
guirančilaxu	ɡʊɪrɑnʧlɑx
guuglaxu	ɡʊːɡlɑx
guulaxu	ɡʊːlɑx
guuǰixu	ɡʊːʤɪx
guuraixu	ɡʊːrɪːx
guursulaxu	ɡʊːrslɑx
guurtuxu	ɡʊːrtɑx
gunixaraxu	ɡʊnɪxrɑx
gunixu	ɡʊnɪx
gunigaxu	ɡʊnʲɡɑx
guniglaxu	ɡʊnɪɡlɑx
guniraxu	ɡʊnʲrɑx
gundaxu	ɡʊndɑx
guŋxaganaxu	ɡʊŋxɡɑnɑx
guŋxalǰaxu	ɡʊŋxɑlʤɪx
guŋganixu	ɡʊŋɡɑnɪx
guŋginaxu	ɡʊŋɡɪnɑx
guŋsixu	ɡʊŋʃɪx
guŋsiginaxu	ɡʊŋʃɪɡnɑx
gubaǰilaxu	ɡʊbʤlɑx
gubigulxu	ɡʏbʊːlɑx
guburuutuxu	ɡʏbrʊːtɑx
gubsixu	ɡʊbʃɪx
gubčiixu	ɡʊbʧɪːx
gubčiurlaxu	ɡʊbʧʊːrlɑx
gubčixu	ɡʊbʧɪx
gubčiganaxu	ɡʊbʧɡɑnɑx
gubčigurlaxu	ɡʊbʧʊːrlɑx
gubčilǰaxu	ɡʊbʧɪlʤɪx
gubčuurlaxu	ɡʊbʧʊːrlɑx
gubčuurdaxu	ɡʊbʧʊːrdɑx
guguglaxu	ɡʊːɡlɑx
gulasxaxu	ɡʊlsɡɑx
gulasxu	ɡʊlsɑx
guladxaxu	ɡʊltɡɑx
guladxu	ɡʊltɑx
gularaxu	ɡʊlrɑx
gulirsixu	ɡʊlɪrʃɪx
gulirdaxu	ɡʊlɪrdɑx
guluuǰalaxu	ɡʊlʊːʣlɑx
gulbiixu	ɡʊlbɪːx
gulbiganaxu	ɡʊlɑbɡɑnɑx
gulbilǰaxu	ɡʊlbɑlʤɪx
gulgixu	ɡʊlɡɪx
gulguxu	ɡʊlɡɑx
gulgugurdaxu	ɡʊlɡʊːrdɑx
gulgurixu	ɡʊlɡɑrɑx
gulduixu	ɡʊldɪːx
gulduganaxu	ɡʊldɡɑnɑx
gulduraxu	ɡʊldrɑx
gulduragudaxu	ɡʊldrʊːdɑx
guldurixu	ɡʊldrɑx
guldurxu	ɡʊldrɑx
gulčiganaxu	ɡʊlʧɡɑnɑx
gulǰaixu	ɡʊlʤɪːx
gulǰabalǰaxu	ɡʊlʤbɑlʤɪx
gulǰaganaxu	ɡʊlʤɡɑnɑx
gulǰalǰaxu	ɡʊlʤɪlʤɪx
gulǰiixu	ɡʊlʤɪːx
gulǰibalǰaxu	ɡʊlʤbɑlʤɪx
gulǰiganaxu	ɡʊlʤɡɑnɑx
gulǰilǰaxu	ɡʊlʤɪlʤɪx
gusiixu	ɡʊʃɪːx
gusibalǰaxu	ɡʊʃbɑlʤɪx
gusilǰaxu	ɡʊʃɪlʤɪx
gutuxu	ɡʊtɑx
gutugaxu	ɡʊtɑːx
gutuldaxu	ɡʊtɑldɑx
guturaxu	ɡʊtrɑx
guduixu	ɡʊdɪːx
gudučixu	ɡʊdʧɪx
guduraxilaxu	ɡʊdɑrxiːləx
guduraxu	ɡʊdrɑx
guduragatuxu	ɡʊdrɑɡtɑx
guduragadaxu	ɡʊdrɑɡdɑx
guduragulxu	ɡʊdrʊːlɑx
gučaxu	ɡʊʧɪx
guyadaxu	ɡʊjdɑx
guyuxu	ɡʊɪx
guyulxilaxu	ɡʊɪlxiːləx
guyučilaxu	ɡʊɪʧlɑx
guranǰudaxu	ɡʊrɑnʤdɑx
guraŋgulaxu	ɡʊrɑŋɡɑlɑx
guraŋgudxu	ɡʊrɑŋɡɑtɑx
gurabalǰaxu	ɡʊrbɑlʤɪx
guralǰaxu	ɡʊrɑlʤɪx
gurigsixu	ɡʊrɪɡʃɪx
gurilsixu	ɡʊrɪlʃɪx
gurildaxu	ɡʊrɪldɑx
guruilaxu	ɡʊrɪːlɑx
gurbalaxu	ɡʊrɑblɑx
gurbalǰilaxu	ɡʊrbɑlʤlɑx
gurbadaxu	ɡʊrɑbdɑx
gurbidaxu	ɡʏrɪbdɑx
gurmusulaxu	ɡʊrɑmslɑx
gurdaixu	ɡʊrdɪːx
gurčiginaxu	ɡʊrʧɪɡnɑx
gurǰaixu	ɡʊrʤɪːx
gurǰalǰaxu	ɡʊrʤɪlʤɪx
guwailaxu	ɡʊælɑx
guwaglaxu	ɡʊɑɡlɑx
guwalaxu	ɡʊɑlɑx
guwadaxu	ɡʊɑdɑx
guwaraxu	ɡʊɑrɑx
guwarsulaxu	ɡʊɑrslɑx
gönǰixü	ɡonʤix
gönǰigürlexü	ɡonʤuːrləx
gönǰigürdexü	ɡonʤuːrdəx
gönǰiyelexü	ɡonʤoːlox
göxidexü	ɡoxiːdox
göxöldexü	ɡoxoldox~xoxoldox
gögxü	ɡoɡox
gögeitüxü	ɡoɡoitox
gögeirexü	ɡoɡoirox
gömisdexü	ɡomosdox
göliixü	ɡoliːx
gölibelǰexü	ɡolbolʤix
göligenexü	ɡoliɡnox
gölilǰexü	ɡolilʤix
gölirexü	ɡolrox
gölögelexü	ɡoloɡlox
gölmidexü	ɡolmiːdox
gölteixü	ɡoltoix
göltegenexü	ɡoltoɡnox
gölčigenexü	ɡolʧiɡnox
gölčögeilexü	ɡolʧɡoilox
göröxü	ɡorox
görögelexü	ɡoroːlox
görxegelexü	ɡorxoːlox
görlexü	ɡorlox
gördexü	ɡordox
güibürdexü	ɡuibərdəx
güixü	ɡuix
güilgexü	ɡuilɡəx
güilgegelexü	ɡuilɡəːləx
güičexü	ɡuiʧix
güičegexü	ɡuiʧəːx
güičeldüxü	ɡuiʧildəx
güičedxexü	ɡuiʧitɡəx
güičedxü	ɡuiʧdəx
güürexü	ɡuːrəx
güürgeilexü	ɡuːrɡiːləx
gündexü	ɡundəx
günǰegeidexü	ɡunʤɡeːdəx
günǰegeirexü	ɡunʤɡeːrəx
günǰegeiregülxü	ɡunʤɡeːruːləx
güŋgenexü	ɡuŋɡənəx
güŋšëǰigülxü	ɡuŋʂəːʤuːləx
gübereütüxü	ɡubruːtəx
güberetüxü	ɡubrəːtəx
gübixü	ɡubəx~ɡobox
gübigürdexü	ɡubuːrdəx~ɡobuːrdəx
gübüixü	ɡubiːx~ɡoboix
gübügenexü	ɡubəɡnəx~ɡoboɡnox
gübsixü	ɡubʃix~ɡobʃix
gübdexü	ɡubdəx~ɡobdox
gübdürüütüxü	ɡubdruːtəx~ɡobdruːtəx
gügüglexü	ɡuːɡləx
güldeixü	ɡuldiːx
güldürexü	ɡuldrəx
güldüregüdexü	ɡuldruːdəx
güdüixü	ɡudiːx
güdülǰexü	ɡudəlʤix
güdüsdexü	ɡudəsdəx
güdxexü	ɡutɡəx
güčelexü	ɡuʧləx
güǰegelexü	ɡuʤəːləx
güǰiixü	ɡuʤiːx
güǰixü	ɡuʤix
güǰirexü	ɡuʤrəx
güǰirmeglexü	ɡuʤirməɡləx
güǰirmegeilexü	ɡuʤrəmɡeːləx
güǰirlexü	ɡuʤirləx
güǰirdexü	ɡuʤirdəx
güyeŋtüxü	ɡujiŋtəx
güyüxü	ɡuix
güyülgexü	ɡuilɡəx
güyüldüxü	ɡuildəx
güyülčexü	ɡuilʧix
güyüdexü	ɡuidəx
güreixü	ɡuriːx
gürelǰexü	ɡurəlʤix
gürimdexü	ɡurəmdəx
gürüxü	ɡurəx
gürbeixü	ɡurbiːx
gürbegenexü	ɡurbəɡnəx
gürbelǰexü	ɡurbəlʤix
gürdeixü	ɡurdiːx
maimailaxu	mæːmæːlɑx
maimarixu	mæːmrɑx
maimugulǰaxu	mæːmɡɑlʤɪx
mailaxu	mæːlɑx
maitaixu	mæːtɪːx
maitaganaxu	mæːtɡɑnɑx
maitalǰaxu	mæːtɑlʤɪx
maidaxu	mæːdɑx
maiǰiixu	mæːʤɪːx
maiǰiginaxu	mæːʤɪɡnɑx
maiǰilǰaxu	mæːʤɪlʤɪx
mairaxu	mæːrɑx
mairagalaxu	mæːrɡɑlɑx
manantuxu	mɑnɑntɑx
manaxu	mɑnɑx
manaraxu	mɑnrɑx
manaragulxu	mɑnrʊːlɑx
maniixu	mɑnɪːx
mantuixu	mɑntɪːx
manduxu	mɑndɑx
mandugulxu	mɑndʊːlɑx
mančuilaxu	mɑnʧɪːlɑx
mančudaxu	mɑnʧdɑx
mančurgalaxu	mɑnʧʊːrɑɡlɑx
mančurgadaxu	mɑnʧʊːrɑɡdɑx
manǰiglaxu	mɑnʤɪɡlɑx
manǰilgalaxu	mɑnʤlɑɡlɑx
maŋxaixu	mɑŋxɪːx
maŋxuuraxu	mɑŋxʊːrɑx
maŋxulaxu	mɑŋxlɑx
maŋlailaxu	mɑŋlæːlɑx
maŋlailagulxu	mɑŋlæːlʊːlɑx
maŋlairxaxu	mɑŋlæːrxɑx
maŋsiguraxu	mɑŋʃʊːrɑx
maxasaxu	mɑxsɑx
maxaraxu	mɑxrɑx
maxiixu	mæːxɪːx
magaguutuxu	mɑːɡʊːtɑx
magaguuraxu	mɑːɡʊːrɑx
magagtuxu	mɑːɡtɑx
magasaixu	mɑːsɪːx
magasaganaxu	mɑːsɡɑnɑx
magasalǰaxu	mɑːsɑlʤɪx
magadaixu	mɑːdɪːx
magadlaxu	mɑɡɑdlɑx
magaǰixu	mɑːʤɪx
magaǰilaxu	mɑːʤlɑx
magaraxu	mɑːrɑx
magarsixu	mɑːrʃɪx
magulaxu	mʊːlɑx
magusiyaxu	mʊːʃɑːx
magudaxu	mʊːdɑx
magudxaxu	mʊːtɡɑx
magudxu	mʊːtɑx
magučilaxu	mʊːʧlɑx
maguǰiraxu	mʊːʤrɑx
magsixu	mɑɡʃɪx
magtaxu	mɑɡtɑx
malagailaxu	mɑlɡæːlɑx
malagaidaxu	mɑlɡæːdɑx
malagairaxu	mɑlɡæːrɑx
maliixu	mælɪːx
maliganaxu	mælɡɑnɑx
malilǰaxu	mælɪlʤɪx
mallaxu	mɑllɑx
maltaxu	mɑltɑx
maltagurdaxu	mɑltʊːrdɑx
malǰixu	mɑlʤɪx
masindaxu	mɑʃɪndɑx
masinčilaxu	mɑʃɪnʧlɑx
masinǰigulxu	mɑʃɪnʤʊːlɑx
masigudaxu	mɑʃʊːdɑx
masilaxu	mɑʃlɑx
mataixu	mɑtɪːx
mataxu	mɑtɑx
matarixu	mɑtrɑx
matarigulxu	mɑtrʊːlɑx
matiixu	mɑtɪːx
madlaxu	mɑdlɑx
mačaglaxu	mɑʧɪɡlɑx
mačuxu	mɑʧɪx
mačulxilaxu	mɑʧɪlxiːləx
maǰuulaxu	mɑʤʊːlɑx
mayiglaxu	mɑjɪɡlɑx
mayuuǰalaxu	mɑːjʊːʣlɑx
maraxu	mɑrɑx
mariyalaxu	mɑrɑːlɑx~mærɪɑlɑx
mariyaǰixu	mɑrɑːʤɪx~mærɪɑʤɪx
marguxu	mɑrɡɑx
margulduxu	mɑrɡɑldɑx
marsaixu	mɑrsɪːx
marsaganaxu	mɑrsɡɑnɑx
marsalǰaxu	mɑrsɑlʤɪx
martaŋnaxu	mɑrtɑɡnɑx
martaxu	mɑrtɑx
marčiixu	mɑrʧɪːx
marǰaŋnaxu	mɑrʤɪɡnɑx
menegsixü	mənəɡʃix
menegtüxü	mənəɡtəx
menerexü	mənrəx
mendülexü	məndləx
mendüčilexü	məndʧiləx
meŋgertüxü	məŋɡərtəx
meŋdenixü	məŋdnəx
meŋdexü	məŋdəx
meŋdegürexü	məŋduːrəx
meŋderexü	məŋdrəx
mexeirexü	məxiːrəx
mexelexü	məxləx
mexedexü	məxdəx
mexerexü	məxrəx
mexüixü	moxoix~məxiːx
mexüisxixü	moxoisxiːx~məxiːsxiːx
mexülǰexü	moxolʤix~məxəlʤix
mexüstüxü	moxostox
mexüsdexü	moxosdox
megsixü	məɡʃix
megsiregülxü	məɡʃruːləx
megǰiixü	məɡʤiːx
meleixü	məliːx
melerexü	məlrəx
melmegenexü	məlməɡnəx
melmelǰexü	məlməlʤix
melmerexü	mələmrəx
melteixü	məltiːx
meltegenexü	məltəɡnəx
meltelǰexü	məltəlʤix
melčeixü	məlʧiːx
melǰixü	məlʤix
melǰiyečexü	məlʤəːʧix
mesedexü	məsdəx
meteixü	mətiːx
metegexü	mətɡəx
medexü	mədəx
medegdexü	mədəɡdəx
medegelexü	mədəːləx
medegülxü	məduːləx
medemexeilexü	mədəmxeːləx
medemexeirexü	mədəmxeːrəx
medemexeirxexü	mədəmxeːrxəx
mederexü	mədrəx
mederxexü	mədərxəx
medxexü	mətɡəx
mereixü	məriːx
merexü	mərəx
mergelexü	mərəɡləx
mergesixü	mərəɡʃix
mergedexü	mərəɡdəx
mergeǰixü	mərəɡʤix
mindaglaxu	mɪndɑɡlɑx
minčiixü	minʧiːx
minčügürexü	minʧuːrəx
minčügüregülxü	minʧuːruːləx
minčürexü	minʧrəx
minčüregülxü	minʧruːləx
mixalaxu	mɑxlɑx
mixasaxu	mɑxsɑx
mixačilaxu	mɑxʧlɑx
mixuuslaxu	mɪxʊːslɑx
milaixu	mɪlɪːx
milaŋtuxu	mɪlɑŋtɑx
miliyaxu	mɪlɪɑx
miltaixu	mɪltɪːx
milǰaŋtuxu	mɪlʤɪŋtɑx
misibelǰexü	miʃbəlʤix
misilǰexü	miʃilʤix
mitaxu	mɪtɑx
mitaraxu	mɪtrɑx
midaixu	mɪdɪːx
midalǰaxu	mɪdɑlʤɪx
miyalaxu	mɪɑlɑx
miraxu	mɪrɑx
miraxu	mɪrɑːx
miralǰaxu	mɪrɑlʤɪx
miriyaxu	mɪrɑːx
miruuslaxu	mɪrʊːslɑx
mirtaxu	mɪrtɑx
moinograxu	mœːnɔɡrɔx
moitoixu	mœːtɔɪx
monopoličilaxu	mɔnpœlʧilɑx
montoixu	mɔntɔɪx
mončoixu	mɔnʧɪːx
mončogonaxu	mɔnʧɡɔnɔx
mončoglaxu	mɔnʧɪɡlɔx
moŋxoixu	mɔŋxɔɪx
moŋxogonaxu	mɔŋxɡɔnɔx
moŋxolǰaxu	mɔŋxɔlʤɪx
moŋgolčilaxu	mɔŋɡɔlʧlɔx
moŋgolǰixu	mɔŋɡɔlʤɪx
moxoxu	mɔxɔx
moxogoxu	mɔxɔːx
moxoraxu	mɔxrɔx
mogairaxu	mɔɡœːrɔx
mogisxu	mœɡsɔx
mogdoixu	mɔɡdɔɪx
mogǰoixu	mɔɡʤɪːx
mogǰoraxu	mɔɡʤrɔx
molčoglaxu	mɔlʧɪɡlɔx
mot'orčilaxu	mɔtɔːrʧlɔx
modolaxu	mɔdlɔx
modoǰixu	mɔdʤɪx
modoraxu	mɔdrɔx
moǰixu	mɔʤɪx
morilaxu	mœrlɔx
mordaxu	mɔrdɔx
mordagulxu	mɔrdʊːlɑx
munaidlaxu	mʊnæːdlɑx
munadaxu	mʊndɑx
munuxu	mʊnɑx
munuglaxu	mʊnɑɡlɑx
munugsixu	mʊnɑɡʃɪx
munugraxu	mʊnɑɡrɑx
mundagurxaxu	mʊndʊːrxɑx
mundaglaxu	mʊndɑɡlɑx
muŋxaguraxu	mʊŋxʊːrɑx
muŋxaglaxu	mʊŋxɑɡlɑx
muŋxaraxu	mʊŋxrɑx
muŋxaragulxu	mʊŋxrʊːlɑx
muŋxaragdaxu	mʊŋxrɑɡdɑx
muŋganixu	mʊŋɡɑnɪx
muŋdanixu	mʊŋdnɪx
muŋdaxu	mʊŋdɑx
muxuixu	mʊxɪːx
muxulaidxu	mʊxlæːdɑx
muxurlaxu	mʊxɑrlɑx
muxurdaxu	mʊxɑrdɑx
muguidlaxu	mʊɡʊɪdlɑx
mugǰiixu	mʊɡʤɪːx
mulguxu	mʊlɡɑx
mulgulxu	mʊlɡɑlɑx
mulguraxu	mʊlɡɑrɑx
mulguraxu	mʊlɡʊːrɑx
multulxu	mʊltlɑx
multuraxu	mʊltrɑx
musiixu	mʊʃɪːx
musxixu	mʊʃɡɪx
musxigurdaxu	mʊʃɡɪʊrdɑx
musxigdaxu	mʊʃɡɪɡdɑx
musxilaxu	mʊʃɪɡlɑx
musxilduxu	mʊʃɡɪldɑx
musxilǰaxu	mʊʃɡɪlʤɪx
musxiraxu	mʊʃɪɡrɑx
muturlaxu	mʊtɑrlɑx
muǰixu	mʊʤɪx~mɔʤɪx
muǰilaxu	mʊʤlɑx~mɔʤlɔx
muǰiyaŋlaxu	mʊʤɑːlɑx
murixu	mʊrɪx
murigudaxu	mʊrɪʊdɑx
muruixu	mʊrɪːx
muruilgaxu	mʊrɪːlɡɑx
muruilǰaxu	mʊrɪːlʤɪx
murulǰaxu	mʊrɑlʤɪx
murguxu	mʊrɡɑx
murčiixu	mʊrʧɪːx
murčiganaxu	mʊrʧɡɑnɑx
murčilǰaxu	mʊrʧɪlʤɪx
möntöixü	montoix
möndöllexü	mondollox
möŋxelexü	moŋxlox
möŋxeǰixü	moŋxʤix
möŋxerexü	moŋxrox
möŋgölexü	moŋɡolox
möxöxü	moxox
möxögexü	moxoːx
möxögeltüxü	moxoːltox
mögerexü	moːrox
mögerlexü	moːrlox
mögersütüxü	moːrstox~moɡoːrstox
mömöxü	moːmox
mömögülxü	moːmuːləx
möliixü	moliːx
mölixü	molix
möligenexü	moliɡnox
mölilǰexü	molilʤix
mölxöxü	molxox
mölxölexü	molxlox
mölxölxilexü	molxolxiːləx
mölxörigülxü	molxruːləx
möltölxü	moltlox
möltörexü	moltrox
mölǰixü	molʤix
mösölexü	moslox
mösötöxü	mostox
mösxixü	moʃɡox
mösxiyerilexü	moʃɡoːrlox
möčexü	moʧix
möčegerxexü	moʧoːrxox
möčixü	moʧix
möčigüdexü	moʧuːdəx
möčimdexü	moʧimdox
möčilexü	moʧlox
möčiddexü	moʧiddox
möčirlexü	moʧirlox
mörilexü	morlox
möröičexü	moroiʧix
möröbčilexü	morobʧlox
mörögedxü	moroːdox
mörölexü	morlox
möröledxü	moroldox
mörgöxü	morɡox
mörgögülxü	morɡuːləx
mörgölexü	moroɡlox
mörgöldüxü	morɡoldox
mörgöčexü	moroɡʧix
mörlexü	morlox
mördexü	mordox
müsibelǰexü	muʃbəlʤix
müsiyexü	muʃəːx
mëxanigǰigulxu	mexɑːnɪɡʤʊːlɑx
mëxanigǰixu	mexɑːnɪɡʤɪx
laimuuslaxu	læːmʊːslɑx
laimuurdaxu	læːmʊːrdɑx
laituxu	læːtɑx
laidaxu	læːdɑx
lantuixu	lɑntɪːx
lantuganaxu	lɑntɡɑnɑx
laŋtuudaxu	lɑŋtʊːdɑx
labaraxu	lɑbrɑx
lablaxu	lɑblɑx
labsaxu	lɑbsɑx
labsixu	lɑbʃɪx
labsiraxu	lɑbʃrɑx
labsiragulxu	lɑbʃrʊːlɑx
labtaixu	lɑbtɪːx
labtaganaxu	lɑbtɡɑnɑx
labtagaraxu	lɑbtɑːrɑx
labtalǰaxu	lɑbtɑlʤɪx
labtaraxu	lɑbtrɑx
labdaxu	lɑbdɑx
labdagulaxu	lɑbdʊːlɑx
labdaguraxu	lɑbdʊːrɑx
labdalaxu	lɑbdlɑx
laxaixu	lɑxɪːx
laguxu	lɑɡɑx
lagulduxu	lɑɡɑldɑx
laglaixu	lɑɡlɪːx
lagsaixu	lɑɡsɪːx
lagsixu	lɑɡʃɪx
lagdaixu	lɑɡdɪːx
lasalaxu	lɑːslɑx
lasadaxu	lɑsdɑx
lat'inčilaxu	lɑtinʧlɑx
ladaxu	lɑːdɑx
ladaraxu	lɑdrɑx
lačadaxu	lɑʧdɑx
laǰalaxu	lɑːʣlɑx
larbaixu	lɑrbɪːx
larǰiyalaxu	lɑrʤɑːlɑx
larǰiyarxaxu	lɑrʤɑːrxɑx
lenteixü	ləntiːx
lentegenexü	ləntəɡnəx
leberexü	ləbrəx
leberegülxü	ləbruːləx
legleixü	ləɡliːx
legseixü	ləɡsiːx
legsixü	ləɡʃix
legegetüxü	ləɡəːtəx
lelbeixü	ləlbiːx
liŋbüdexü	limbədəx
limbüdexü	limbədəx
loŋxoixu	lɔŋxɔɪx
loŋxogordaxu	lɔŋxɡɔrdɔx
loŋxolaxu	lɔŋxlɔx
lobxotoxu	lɔbxtɔx
lobsilaxu	lɔbʃlɔx
lobsidaxu	lɔbʃdɔx
lobsiraxu	lɔbʃrɔx
loxoixu	lɔxɔɪx
logloixu	lɔɡlɔɪx
logsixu	lɔɡʃɪx
logsoolaxu	lɔɡsɔːlɔx
lombodaxu	lɔmbɔdɔx
luibardaxu	lʊɪbɑrdɑx
luibarčilaxu	lʊɪbɑrʧlɑx
luuxatuxu	lʊːxtɑx
luŋsuilaxu	lʊŋsʊɪlɑx
luxaixu	lʊxɪːx
lugsixu	lʊɡʃɪx
lölödexü	loːloːdox
lübxixü	lubxiːx
lügxixü	luɡxiːx
lüglüixü	luɡliːx
lüǰiginexü	luʤiɡnəx
saiburlaxu	sæːbɑrlɑx
saimsuraxu	sæːmsrɑx
sailuurdaxu	sæːlʊːrdɑx
saisadaxu	sæːsdɑx
saisiyaxu	sæːʃɑːx
saiǰadaxu	sæːʤdɑx
saiǰiraxu	sæːʤrɑx
saiǰiragulxu	sæːʤrʊːlɑx
sairaxu	sæːrɑx
sairxaxu	sæːrxɑx
sanaxu	sɑnɑx
sanagalǰaxu	sɑnɡɑlʤɪx
sanagasiraxu	sɑnɑːʃrɑx
sanagačilaxu	sɑnɑːʧlɑx
sanagarxaxu	sɑnɑːrxɑx
sanagulxu	sɑnʊːlɑx
sanagdaxu	sɑnɑɡdɑx
sanamsarlaxu	sɑnɑmsɑrlɑx
sanamǰilaxu	sɑnɑmʤlɑx
sandailaxu	sɑndæːlɑx
sandairaxu	sɑndæːrɑx
sandaxu	sɑndɑx
sandagaxu	sɑndɑːx
sandaraxu	sɑndrɑx
sandaragaxu	sɑndrɑːx
sanduudaxu	sɑndʊːdɑx
sandurxu	sɑndrɑx
sandurgaxu	sɑndɑrɡɑx
sanǰiixu	sɑnʤɪːx
sanǰixu	sɑnʤɪx
sanǰiginaxu	sɑnʤɪɡnɑx
sanǰilǰaxu	sɑnʤɪlʤɪx
saŋnaxu	sɑɡnɑx
saŋxaixu	sɑŋxæːx
saŋxailčaxu	sɑŋxæːlʧɪx
saŋxaraxu	sɑŋxrɑx
saŋxilxu	sæŋxlɑx
saŋgaxu	sɑŋɡɑx
saŋgasxixü	sɑŋɡɑsxiːx
saŋguixu	sɑŋɡæːx
saŋsalaxu	sɑŋslɑx
saŋdaguraxu	sɑndʊːrɑx
sabaxu	sɑbɑx
sabaganaxu	sɑbɡɑnɑx
sabagadaxu	sɑbɡɑdɑx
sabagadaxu	sɑbɑːdɑx
sabalaxu	sɑblɑx
sabadaxu	sɑbdɑx
sabačixu	sɑbʧɪx
sabardaxu	sɑbɑrdɑx
sabiraxu	sæbrɑx
sabiragulxu	sæbrʊːlɑx
sabxalaxu	sɑbxlɑx
sabxadaxu	sɑbxdɑx
sabsaxu	sɑbsɑx
sabsalgalaxu	sɑbslɑɡlɑx
sabsalgadaxu	sɑbslɑɡdɑx
sabdaxu	sɑbdɑx
saxaldaxu	sɑxɑldɑx
saxadaxu	sɑxdɑx
saxaraxu	sɑxrɑx
saxixu	sæxɪx
saxuixu	sɑxɪːx
saxuutuxu	sɑxʊːtɑx
saxuuraxu	sɑxʊːrɑx
sagaxu	sɑːx
sagagdaxu	sɑːɡdɑx
sagamasixu	sɑːmʃɪx
sagamasiraxu	sɑːmʃrɑx
sagalidaxu	sɑːlʲdɑx
sagaldurgalaxu	sɑɡɑldrɑɡlɑx
sagataxu	sɑːtɑx
sagatagulxu	sɑːtʊːlɑx
sagadaglaxu	sɑːdɑɡlɑx
sagaraxu	sɑːrɑx
sagarituxu	sæːrtɑx
sagarmaglaxu	sɑːrmɑɡlɑx
sagarmagtuxu	sɑːrmɑɡtɑx
sagarmagǰixu	sɑːrmɑɡʤɪx
saguxu	sʊːx
sagugdaxu	sʊːɡdɑx
sagulgaxu	sʊːlɡɑx
sagulčaxu	sʊːlʧɪx
sagudxaxu	sʊːtɡɑx
sagurilaxu	sʊɪrlɑx
sagurisixu	sʊɪrʃɪx
sagurisigulxu	sʊɪrʃʊːlɑx
saggaxu	sɑɡɑx
saglaixu	sɑɡlɪːx
saglaganaxu	sɑɡlɑɡnɑx
saglalǰaxu	sɑɡlɑlʤɪx
sagsaixu	sɑɡsɪːx
sagsaganaxu	sɑɡsɡɑnɑx
sagsaguraxu	sɑɡsʊːrɑx
sagsalǰaxu	sɑɡsɑlʤɪx
sagsaraxu	sɑɡsrɑx
sagsulaxu	sɑɡslɑx
sagsurgatuxu	sɑɡsrɑɡtɑx
samaguraxu	sɑmʊːrɑx
samaguragulxu	sɑmʊːrʊːlɑx
samučaxu	sɑmʧɪx
samučixu	sɑmʧɪx
samurxu	sɑmrɑx
samnaxu	sɑmnɑx
sambaganaxu	sɑmbɑɡɑnɑx
sambagalaxu	sɑmbɑːlɑx
sambagačilaxu	sɑmbɑːʧlɑx
samgardaxu	sɑmɡɑrdɑx
samsixu	sɑmʃɪx
salagabčilaxu	sɑlɑːbʧlɑx
salagalaxu	sɑlɑːlɑx
saluŋgiraxu	sɑlɑŋɡɪrɑx
salbaixu	sɑlbɪːx
salbaxu	sɑlbɑx
salbaganaxu	sɑlɑbɡɑnɑx
salbalǰaxu	sɑlbɑlʤɪx
salbadaxu	sɑlɑbdɑx
salbaraxu	sɑlɑbrɑx
salburilaxu	sɑlbɑrlɑx
salxaixu	sɑlxɪːx
salxaganaxu	sɑlxɡɑnɑx
salxalǰaxu	sɑlxɑlʤɪx
salxilaxu	sælxlɑx
salxidaxu	sælxdɑx
salxu	sɑlɑx
salganaxu	sɑlɡɑnɑx
salgaxu	sɑlɡɑx
salgalaxu	sɑlɡɑlɑx
salgatuxu	sɑlɡɑtɑx
salgadaxu	sɑlɡɑdɑx
sallaxu	sɑllɑx
saltaixu	sɑltɪːx
saltagadaxu	sɑltɑːdɑx
saldaixu	sɑldɪːx
salǰiixu	sɑlʤɪːx
satagaraxu	sɑtɑːrɑx
sadaganaxu	sɑdɡɑnɑx
sadaraxu	sɑdrɑx
saduŋnaxu	sɑdɑɡnɑx
sadumsaglaxu	sɑdɑmsɑɡlɑx
sadurxaxu	sɑdɑrxɑx
sadurlaxu	sɑdɑrlɑx
sačagulaxu	sɑʧʊːlɑx
sačagudaxu	sɑʧʊːdɑx
sačalaxu	sɑʧlɑx
sačuxu	sɑʧɪx
sačuglaxu	sɑʧɪɡlɑx
sačulaxu	sɑʧlɑx
sačučixu	sɑʧʧɪx
sačuraxu	sɑʧrɑx
saǰixu	sɑʤɪx
saǰigčixu	sɑʤɪɡʧɪx
saǰilaxu	sɑʤlɑx
saǰilagulxu	sɑʤlʊːlɑx
saǰilǰaxu	sɑʤɪlʤɪx
saraixu	sɑrɪːx
sarabčilaxu	sɑrɑbʧlɑx
saragulsixu	sɑrʊːlʃɪx
saralaxu	sɑrɑːlɑx~sɑrlɑx
saralǰilaxu	sɑrɑːlʤlɑx
saralǰidaxu	sɑrɑːlʤdɑx
sarixu	særɪx
sarigalaxu	særɡɑːlɑx
sarisulaxu	særslɑx
sarnaixu	sɑrnɪːx
sarnixu	særnɑx
sarnigulxu	særnʊːlɑx
sarnigudaxu	særnʊːdɑx
sarbaixu	sɑrbɪːx
sarbaxu	sɑrbɑx
sarbaganaxu	sɑrɑbɡɑnɑx
sarbalǰaxu	sɑrbɑlʤɪx
sarbadaxu	sɑrbɑːdɑx
sarxaixu	sɑrxɪːx
sarmaixu	sɑrmɪːx
sarmiixu	særmɪːx
sarsaixu	sɑrsɪːx
sartaixu	sɑrtɪːx
sartaganaxu	sɑrtɡɑnɑx
sartalǰaxu	sɑrtɑlʤɪx
sarčiixu	sɑrʧɪːx
sarčiginaxu	sɑrʧɪɡnɑx
sarčilǰaxu	sɑrʧɪlʤɪx
sarǰaixu	sɑrʤɪːx
seixü	siːx
seigexü	siːɡəx
seimeixü	siːmiːx
seilbürilexü	siːlbərləx
seilxü	siːləx
seičixü	siːʧix
seičilexü	siːʧləx
seirexü	siːrəx
seiregsixü	siːrəɡʃix
seiregdexü	siːrəɡdəx
seiregülxü	siːruːləx
sendeilexü	səndiːləx
sendexü	səndəx
sendelxü	səndləx
sendečixü	səndʧix
senǰilexü	sənʤləx
senǰidexü	sənʤdəx
seŋxelǰexü	səŋxəlʤix
seŋxerexü	səŋxrəx
seŋxeregülxü	səŋxruːləx
seŋginexü	səŋɡənəx
seŋselexü	səŋsləx
seŋserexü	səŋsrəx
seŋdexü	səŋdəx
sebegenexü	səbəɡnəx
sebegürxexü	səbuːrxəx
sebelǰexü	səbəlʤix
sebesülexü	səbsləx
sebesüdexü	səbsdəx
sebesürexü	səbsrəx
seberexü	səbrəx
seberegexü	səbrəːx
sebixü	səbəx
sebigürdexü	səbuːrdəx
sebilexü	səbləx
sebilǰexü	səbəlʤix
sebürxexü	səbərxəx
sebxetüxü	səbxtəx
sebxixü	səbxiːx
seblexü	səbləx
sebseixü	səbsiːx
sebsexü	səbsəx
sebsegenexü	səbsəɡnəx
sebselǰexü	səbsəlʤix
sebsiyelexü	səbʃəːləx
sebtüxü	səbtəx
sexexü	səxəx
segexü	səɡəx
sexegerexü	səxəːrəx
sexegeregülxü	səxəːruːləx
sexerexü	səxrəx
sexüixü	səxuix~soxoix
sexüilčexü	səxuilʧix~soxoilʧix
sexüxü	soxox
sexügdexü	soxoɡdox
sexürexü	səxrəx
segxixü	səɡxiːx
segleixü	səɡliːx
seglexü	səɡləx
segseixü	səɡsiːx
segsegenexü	səɡsəɡnəx
segselǰexü	səɡsəlʤix
segsülexü	səɡsləx
segsürxilexü	səɡsərxiːləx
segsürxü	səɡsrəx
segexelǰexü	səːxəlʤix
segeldürgelexü	səɡəldrəɡləx
segeteixü	səːtiːx
segetegenexü	səːtəɡnəx
segetelǰexü	səːtəlʤix
segerdexü	səːrdəx
següldexü	suːldəx
següdeixü	suːdiːx
següdegenexü	suːdəɡnəx
següdegelǰexü	suːdɡəlʤix
següdelǰexü	suːdəlʤix
següderlexü	suːdərləx
següdertüxü	suːdərtəx
semelxü	səmləx
semeseixü	səmsiːx
semeserexü	səmsrəx
semeǰelexü	səmʤləx
semerexü	səmrəx
sembeixü	səmbiːx
sembegenexü	səmbəɡnəx
sembelǰexü	səmbəlʤix
selexü	sələx
selegüčexü	səluːʧix
selegürexü	səluːrəx
selibegenexü	səlbəɡnəx
selibelǰexü	səlbəlʤix
selixü	sələx
seligürdexü	səluːrdəx
selbixü	səlbəx
selbigürdexü	səlbuːrdəx
selbičexü	sələbʧix
selxüixü	səlxiːx
selxütüxü	səlxtəx
selxürexü	səlxrəx
selgüxü	səlɡəx
selgüčexü	səlɡuːʧix
seltexü	səltəx
seltürexü	səltrəx
setelxü	sətləx
seterexü	sətrəx
seterlexü	sətərləx
sedexü	sədəx
sederexü	sədrəx
sederegtüxü	sədrəɡtəx
sedüblexü	sədəbləx
sedübčilexü	sədəbʧləx
sedüxü	sədəx
sedxexü	sətɡəx
sedxixü	sətɡəx
sedxigdexü	sətɡəɡdəx
sedxilčilexü	sətɡəlʧləx
sečelexü	səʧləx
sečerxexü	səʧirxəx
seǰixü	səʤix
seǰiglexü	səʤiɡləx
seǰigürdexü	səʤuːrdəx
seǰilexü	səʤləx
sereixü	səriːx
serexü	sərəx
seregdexü	sərəɡdəx
seregedexü	sərəːdəx
seremǰilexü	sərəmʤləx
serixü	sərəx
serigexü	sərəːx
serigüdexü	səruːdəx
serigüdxü	səruːtəx
serigüčexü	səruːʧix
seriyedexü	sərəːdəx
serbeixü	sərbiːx
serbegenexü	sərbəɡnəx
serbelǰexü	sərbəlʤix
serbesxixü	sərbəsxiːx
serxeixü	sərxiːx
serxebelǰexü	sərxbəlʤix
serxelexü	sərxləx
serxelǰexü	sərxəlʤix
sergeilexü	sərɡiːləx
sergeglexü	sərɡəɡləx
sergüxü	sərɡəx
sergügexü	sərɡəːx
sergüsxixü	sərɡəsxiːx
sermexü	sərməx
serteixü	sərtiːx
serteŋdüxü	sərtəŋdəx
sertebelǰexü	sərtbəlʤix
sertegenexü	sərtəɡnəx
sertelǰexü	sərtəlʤix
serdexü	sərdəx
serčiginexü	sərʧiɡnəx
serǰiginexü	sərʤiɡnəx
serǰimlexü	sərʤimləx
siidbürilexü	ʃiːdbərləx
siidxü	ʃiːdəx
sinagalaxu	ʃɑnɡɑlɑx
sinalaxu	ʃɪnɑːlɑx
sinalxu	ʃɪnlɑx
sinaraxu	ʃɪnɑːrɑx
sinelexü	ʃinləx
sinedxexü	ʃintɡəx
sinedxü	ʃindəx
sinečilexü	ʃinʧləx
sinerxexü	ʃinərxəx
sinuxailaxu	ʃʊnxæːlɑx
sinuxairaxu	ʃʊnxæːrɑx
sinuxu	ʃʊnɑx
sintaixu	ʃɪntɪːx
sintaganaxu	ʃɪntɡɑnɑx
sintalaxu	ʃɪntlɑx
sintalǰaxu	ʃɪntɑlʤɪx
sintaraxu	ʃɪntrɑx
sinǰixü	ʃinʤix
sinǰilexü	ʃinʤləx
siŋnaixu	ʃɑɡnɪːx
siŋxulaxu	ʃʊŋxlɑx
siŋxudaxu	ʃʊŋxdɑx
siŋgexü	ʃiŋɡəx
siŋgegexü	ʃiŋɡəːx
siŋgelexü	ʃiŋɡələx
siŋgedexü	ʃiŋɡədəx
siŋgedxexü	ʃiŋɡətɡəx
siŋgedxü	ʃiŋɡətəx
siŋgerexü	ʃiŋɡərəx
siŋgeregülxü	ʃiŋɡəruːləx
siŋsixü	ʃiŋʃix
siŋsilexü	ʃiŋʃləx
sibaŋdaxu	ʃɑbɑŋdɑx
sibaxu	ʃɑbɑx
sibagalaxu	ʃɑbɑːlɑx
sibagasulaxu	ʃɑbɑːslɑx
sibagaraxu	ʃɑbɑːrɑx
sibagaralduxu	ʃɑbɑːrɑldɑx
sibalduxu	ʃɑbɑldɑx
sibadaxu	ʃɑbdɑx
sibadagudaxu	ʃɑbdʊːdɑx
sibartuxu	ʃɑbɑrtɑx
sibardaxu	ʃɑbɑrdɑx
sibenexü	ʃibnəx
sibeneldüxü	ʃibnəldəx
sibexü	ʃibəx
sibegenexü	ʃibəɡnəx
sibegelexü	ʃibəːləx
sibegesülexü	ʃibəːsləx
sibegürdexü	ʃibuːrdəx
sibelidexü	ʃibəldəx
siberexü	ʃibrəx
siberegenexü	ʃibrəɡnəx
siberilexü	ʃibərləx
siberitüxü	ʃibərtəx
sibögelexü	ʃoboɡlox
sibögedexü	ʃoboɡdox
sibögerexü	ʃoboɡrox
sibxaituxu	ʃɑbxæːtɑx
sibxaxu	ʃɑbxɑx
sibxatuxu	ʃɑbxtɑx
sibxadaxu	ʃɑbxdɑx
sibxačixu	ʃɑbxʧɪx
sibxaraxu	ʃɑbxrɑx
sibxarxu	ʃɑbxrɑx
sibxartuxu	ʃɑbxɑrtɑx
sibxerexü	ʃibxrəx
sibsixü	ʃibʃix
sibsirgadaxu	ʃɑbʃrɑɡdɑx
sibtulxu	ʃʊbtlɑx
sibtučixu	ʃʊbtʧɪx
sibturaxu	ʃʊbtrɑx
sibturxu	ʃʊbtrɑx
sixaxu	ʃɑxɑx
sixagdaxu	ʃɑxɑɡdɑx
sixamdaxu	ʃɑxɑmdɑx
sixamdagulxu	ʃɑxɑmdʊːlɑx
sixalduxu	ʃɑxɑldɑx
sixalčaxu	ʃɑxɑlʧɪx
sixačaxu	ʃɑxʧɪx
sixačalduxu	ʃɑxʧɪldɑx
sixardaxu	ʃɑxɑrdɑx
sixardagulxu	ʃɑxɑrdʊːlɑx
sixirlexü	ʃixərləx
sixirǰixü	ʃixərʤix
sixirǰigülxü	ʃixərʤuːləx
sixuidaxu	ʃɔxœːdɔx
sixürlexü	ʃuxərləx
sigsixü	ʃiɡʃix
sigaxu	ʃɑːx
sigalčaxu	ʃɑːlʧɪx
sigarulaxu	ʃɑːrlɑx
sigexü	ʃəːx
sigelgexü	ʃəːlɡəx
sigesürexü	ʃəːsrəx
sigereŋtüxü	ʃəːrəŋtəx
sigerexü	ʃəːrəx
sigidxexü	ʃiɡtɡəx
sigidxü	ʃiɡdəx
sigidrexü	ʃiɡdrəx
sigičixü	ʃiɡʧix
sigičilexü	ʃiɡʧləx
sigiralaxu	ʃɪːrlɑx
sigiradaxu	ʃɪːrdɑx
siguiǰixu	ʃʊɡʊɪʤɪx
siguiǰigulxu	ʃʊɡʊɪʤʊːlɑx
siguiraxu	ʃʊɡʊɪrɑx
siguxu	ʃʊːx
sigugdaxu	ʃʊːɡdɑx
sigudailaxu	ʃʊːdæːlɑx
sigudaglaxu	ʃʊːdɑɡlɑx
siguduguraxu	ʃʊːdʊːrɑx
sigudburilaxu	ʃʊːdbɑrlɑx
sigudxu	ʃʊːdɑx
sigudraxu	ʃʊːdrɑx
siguraxu	ʃʊːrɑx
sigurxailaxu	ʃʊːrxæːlɑx
sigurxu	ʃʊːrɑx
sigurgalaxu	ʃʊːrɡɑlɑx
sigurgadaxu	ʃʊːrɡɑdɑx
sigüxü	ʃuːx
sigümǰilexü	ʃuːmʤləx~ʃuɡəmʤləx
sigülxü	ʃuːləx
sigülgexü	ʃuːlɡəx
sigüsülexü	ʃuːsləx
sigüderilexü	ʃuːdərləx
sigüderitüxü	ʃuːdərtəx
sigürexilexü	ʃuːrxiːləx
sigürexü	ʃuːrəx
sigürxü	ʃuːrəx
sig°laxu	ʃɪɡlɑx
simalaxu	ʃɑmlɑx
simaraxu	ʃɑmrɑx
simarxu	ʃɑmrɑx
simexü	ʃiməx
simedüxü	ʃimdəx
simedxü	ʃimdəx
simxüxü	ʃimxəx
simsirexü	ʃimʃrəx
simsiridxü	ʃimʃirtəx
simdaxu	ʃɑmdɑx
simdagailaxu	ʃɑmdɡæːlɑx
simdagulxu	ʃɑmdʊːlɑx
silegexü	ʃiləːx
silemedexü	ʃiləmdəx
silibelǰexü	ʃilbəlʤix
silixü	ʃiləx
sililexü	ʃilləx
silirexü	ʃilrəx
silirxexü	ʃilərxəx
silugudxaxu	ʃʊlʊːtɡɑx
silugudxu	ʃʊlʊːtɑx
siluguraxu	ʃʊlʊːrɑx
silüxeitüxü	ʃulxeːtəx
silüxeirexü	ʃulxeːrəx
silüglexü	ʃuləɡləx
silüsütüxü	ʃulstəx
silüsüdexü	ʃulsdəx
silbigürdexü	ʃilbuːrdəx
silbidexü	ʃiləbdəx
silbulxu	ʃɑlɑblɑx
silbučixu	ʃɑlɑbʧɪx
silburaxu	ʃɑlɑbrɑx
silgaxu	ʃɪlɡɑx
silgagulxu	ʃɪlɡʊːlɑx
silgaraxu	ʃɪlɡɑrɑx
silgaragulxu	ʃɪlɡɑrʊːlɑx
silgegexü	ʃilɡəːx
silmüüsütüxü	ʃilmuːstəx
sillexü	ʃilləx
siltaxu	ʃɪltɑx
siltagalaxu	ʃɪltɡɑːlɑx
siltagačaxu	ʃɪltɡɑːʧɪx
siltaglaxu	ʃɪltɑɡlɑx
siltüxü	ʃiltəx
siltügünexü	ʃiltəɡnəx
silǰalxu	ʃɪlʤlɑx
silǰaraxu	ʃɪlʤrɑx
silǰixü	ʃilʤix
silǰigülxü	ʃilʤuːləx
sist'ëmčilexü	ʃistemʧləx
sist'ëmǰigülxü	ʃistemʤuːləx
sitaxu	ʃɪtɑx
sitagaxu	ʃɪtɑːx
sitaradaxu	ʃɪtɑrdɑx
sitaračaxu	ʃɪtɑrʧɪx
sitüxü	ʃutəx
sitülčexü	ʃutəlʧix
sidamlaxu	ʃɪːdɑmlɑx
sidamdaxu	ʃɪːdɑmdɑx
sidarlaxu	ʃɪdɑrlɑx
sidardaxu	ʃɪdɑrdɑx
sidexü	ʃidəx
sidemelexü	ʃidəmləx
sidemesülexü	ʃidəmsləx
siderexü	ʃidrəx
sidurgulaxu	ʃʊdrɑɡlɑx
sidurgusixu	ʃʊdrɑɡʃɪx
sidurgudaxu	ʃʊdrɑɡdɑx
sidurgudxu	ʃʊdrɑɡtɑx
sidülexü	ʃudləx
sidxexü	ʃiːtɡəx
siǰalxu	ʃɪʤlɑx
siǰaraxu	ʃɪʤrɑx
siǰiŋtüxü	ʃiʤiŋtəx
siǰiginexü	ʃiʤiɡnəx
siǰimnexü	ʃiʤimnəx
siǰimlexü	ʃiʤimləx
siraxu	ʃɑrɑx
siramdaglaxu	ʃɑrɑmdɑɡlɑx
siralaxu	ʃɑrlɑx
siralagaxu	ʃɑrɑlɡɑx
siralagulxu	ʃɑrlʊːlɑx
siralxaxu	ʃɑrɑlxɑx
siratuxu	ʃɑrtɑx
siregelexü	ʃirəːləx
siregeledxü	ʃirəːldəx
siremüsixü	ʃirəmʃix
sirixü	ʃirəx
sirigexü	ʃirəːx
sirimeglexü	ʃirməɡləx
sirilexü	ʃirləx
sirildüxü	ʃirəldəx
siroitoxu	ʃɔrɔːtɔx
siroitogulxu	ʃɔrɔːtʊːlɑx
siruglaxu	ʃʊrɑɡlɑx
sirügülexü	ʃuruːləx
sirügüsxü	ʃuruːsəx
sirügüdxü	ʃuruːtəx
sirbaxu	ʃɑrbɑx
sirbaganaxu	ʃɑrɑbɡɑnɑx
sirbalǰaxu	ʃɑrbɑlʤɪx
sirbegetüxü	ʃirbəːtəx
sirbixü	ʃirbəx
sirbiginexü	ʃirbəɡnəx
sirbösölexü	ʃorboslox
sirxatuxu	ʃɑrxtɑx
sirxatugulxu	ʃɑrxtʊːlɑx
sirxeixü	ʃirxiːx
sirxeglexü	ʃirxəɡləx
sirxegǰixü	ʃirxəɡʤix
sirxetüxü	ʃirxtəx
sirxirexü	ʃirxrəx
sirgaxu	ʃɑrɡɑx
sirgagaxu	ʃɑrɡɑːx
sirgixü	ʃirɡəx
sirgigexü	ʃirɡəːx
sirguxu	ʃʊrɡɑx
sirgugulxu	ʃʊrɡʊːlɑx
sirgulaxu	ʃʊrɡɑlɑx
sirlexü	ʃirləx
sirtebelǰexü	ʃirtbəlʤix
sirtexü	ʃirtəx
sirtelxilexü	ʃirtəlxiːləx
sird'xixü	ʃirdxiːx
sirdexü	ʃirdəx
sirčiginexü	ʃirʧiɡnəx
soixu	sœːx
soilxu	sœːlɔx
sonirxaxu	sœnɪrxɔx
sonosogdaxu	sɔnsɔɡdɔx
sonosxaxu	sɔnsɡɔx
sonosxu	sɔnsɔx
sonosdaxu	sɔnsdɔx
sonordaxu	sɔnɔrdɔx
sondoixu	sɔndɔɪx
sondogoidaxu	sɔndɡœːdɔx
sondogoiraxu	sɔndɡœːrɔx
sonǰixu	sɔnʤɪx
soŋgoxu	sɔŋɡɔx
soŋgogdaxu	sɔŋɡɔɡdɔx
soxoixu	sɔxɔɪx
soxolxu	sɔxlɔx
soxolǰaxu	sɔxɔlʤɪx
soxočixu	sɔxʧɪx
soxoraxu	sɔxrɔx
sogoixu	sɔɡɔɪx
sogoxolǰaxu	sɔːxɔlʤɪx
sogoglaxu	sɔɡɔɡlɔx
sogogtoxu	sɔɡɔɡtɔx
sogogdaxu	sɔɡɔɡdɔx
sogograxu	sɔɡɔɡrɔx
sogotogonaxu	sɔːtɡɔnɔx
sogotolǰaxu	sɔːtɔlʤɪx
sogsixu	sɔɡʃɪx
sogsoixu	sɔɡsɔɪx
sogsogonaxu	sɔɡsɡɔnɔx
sogsogdaxu	sɔɡsɔɡdɔx
sogsolǰaxu	sɔɡsɔlʤɪx
sogtoxu	sɔɡtɔx
sogtogaxu	sɔɡtɔːx
sogtoguraxu	sɔɡtʊːrɑx
sogtogurxaxu	sɔɡtʊːrxɑx
solixu	sœlɪx
soliguraxu	sœlɪʊrɑx
soligdaxu	sœlɪɡdɔx
solilčaxu	sœlɪlʧɪx
soličaxu	sœlʧɪx
soličalduxu	sœlʧɪldɔx
soliyatuxu	sœlɪɔtɔx
soliyaraxu	sœlɪɔrɔx
soloŋgalaxu	sɔlɔŋɡɔlɔx
soloŋgatuxu	sɔlɔŋɡɔtɔx
soloŋgaraxu	sɔlɔŋɡɔrɔx
solbixu	sœlbɔx
solbilčaxu	sœlbɔlʧɪx
solbičaxu	sœlɪbʧɪx
solǰiixu	sœlʤɪːx
sodolaxu	sɔdlɔx
sočixu	sɔʧɪx
sočigaxu	sɔʧɔːx
sočimagdaxu	sɔʧmɔɡdɔx
sočimdaxu	sɔʧɪmdɔx
soyoxu	sɔjɪx
soyogalaxu	sɔjɔːlɔx
soyogalagulxu	sɔjɔːlʊːlɑx
soyogadaxu	sɔjɔːdɔx
soyogaraxu	sɔjɔːrɔx
soyolǰixu	sɔjɪlʤɪx~sʊjɪlʤɪx
soyolǰigulxu	sɔjɪlʤʊːlɑx~sʊjɪlʤʊːlɑx
soyorxaxu	sɔjɪrxɔx
sorinčilaxu	sɔrɔnʧlɔx
sorinčitoxu	sɔrɔnʧtɔx
sorinčidaxu	sɔrɔnʧdɔx
sorinǰinǰixu	sɔrɔnʤɪnʤɪx
sorinǰilaxu	sɔrɔnʤlɔx
sorinǰitoxu	sɔrɔnʤtɔx
sorinǰidaxu	sɔrɔnʤdɔx
sorixu	sœrɪx
sorisolaxu	sœrslɔx
soroxu	sɔrɔx
sorogulxu	sɔrʊːlɑx
soroguldaxu	sɔrʊːldɑx
sorbitoxu	sœrɪbtɔx
sorboixu	sɔrbɔɪx
sorgoglaxu	sɔrɡɔɡlɔx
sorlaxu	sɔrlɔx
sorloxu	sɔrlɔx
sorsolaxu	sɔrslɔx
sortoixu	sɔrtɔɪx
sortoilgaxu	sɔrtɔɪlɡɔx
sortoolaxu	sɔrtɔːlɔx
sortoorxaxu	sɔrtɔːrxɔx
sortogonaxu	sɔrtɡɔnɔx
sortolǰaxu	sɔrtɔlʤɪx
suibdaxu	sʊɪbdɑx
suilaxu	sʊɪlɑx
suitaganaxu	sʊɪtɡɑnɑx
suitalǰaxu	sʊɪtɑlʤɪx
suiraxu	sʊɪrɑx
suiradaxu	sʊɪrdɑx
suniixu	sʊnɪːx
suniyaxu	sʊnɪɑx
sunuxu	sʊnɑx
sunugaxu	sʊnɡɑx
sundalaxu	sʊndlɑx
sunǰiixu	sʊnʤɪːx
sunǰixu	sʊnʤɪx
sunǰiganaxu	sʊnʤɡɑnɑx
sunǰigardaxu	sʊnʤɡɑrdɑx
sunǰiguraxu	sʊnʤʊːrɑx
sunǰiraxu	sʊnʤrɑx
sunǰiragulxu	sʊnʤrʊːlɑx
sunǰuxu	sʊnʤɪx
sunǰuguraxu	sʊnʤʊːrɑx
sunǰuraxu	sʊnʤrɑx
suŋxu	sʊnɑx
suŋgaxu	sʊŋɡɑx
subailaxu	sʊbæːlɑx
subairaxu	sʊbæːrɑx
subaglaxu	sʊbɑɡlɑx
subagtuxu	sʊbɑɡtɑx
subagǰixu	sʊbɑɡʤɪx
subagǰigulxu	sʊbɑɡʤʊːlɑx
subagraxu	sʊbɑɡrɑx
subixu	sʏbɪx
subilaxu	sʏblɑx~sœblɔx
subuxu	sʊbɑx
subudlaxu	sʊbdlɑx
suburaxu	sʊbrɑx
suburagaxu	sʊbrɑːx
suburgalaxu	sʊbrɑɡlɑx
subsuraxu	sʊbsrɑx
subdaglaxu	sʊbdɑɡlɑx
suguixu	sʊɡɪːx
sugunaglaxu	sʊːnɑɡlɑx
sugubdaxu	sʊːbdɑx
sugubčilaxu	sʊːbʧlɑx
sugulaxu	sʊːlɑx
sugulixu	sʊɪlɑx
sugulxu	sʊɡlɑx
suguldurxu	sʊɡɑldrɑx
suguldurgalaxu	sʊɡɑldrɑɡlɑx
sugudaxu	sʊːdɑx
sugučixu	sʊɡʧɪx
suguraxu	sʊɡrɑx
sugsaixu	sʊɡsɪːx
sugsalǰaxu	sʊɡsɑlʤɪx
sugsurxu	sʊɡsrɑx
sugdaixu	sʊɡdɪːx
sugdalxu	sʊɡdlɑx
sumulaxu	sʊmlɑx
sumudaxu	sʊmdɑx
sulalaxu	sʊllɑx
suladaxu	sʊldɑx
suladxaxu	sʊltɡɑx
suladxu	sʊltɑx
sularaxu	sʊlrɑx
sularagulxu	sʊlrʊːlɑx
sulbaixu	sʊlbɪːx
sulbagardaxu	sʊlɑbɡɑrdɑx
suldaixu	sʊldɪːx
suldaganaxu	sʊldɡɑnɑx
suldagardaxu	sʊldɡɑrdɑx
sudaltuxu	sʊdɑltɑx
sudulxu	sʊdlɑx
sudurlaxu	sʊdɑrlɑx
sudurčilaxu	sʊdɑrʧlɑx
suraxu	sʊrɑx
suraglaxu	sʊrɑɡlɑx
surulčaxu	sʊrɑlʧɪx
surbulǰilaxu	sʊrbɑlʤlɑx
surxiraxu	sʊrxʲrɑx
surxu	sʊrɑx
surgaxu	sʊrɡɑx
surgagulilaxu	sʊrɡʊːllɑx
surgamǰilaxu	sʊrɡɑmʤlɑx
surtalčilaxu	sʊrtɑlʧlɑx
surčiginaxu	sʊrʧɪɡnɑx
suwampandaxu	sʊmpɑndɑx
sönöxü	sonox
sönögexü	sonoːx
söndölexü	sondlox
söŋnexü	soɡnox
söxögexü	soxoːx
söxödexü	soxdox
söxörexü	soxrox
sögeŋgitüxü	soːŋɡotox
sögexü	soːx
sögergülexü	soːroɡlox
sögömnexü	soːmnox
sögömlexü	soːmlox
sögölexü	soɡlox
sögödxü	soɡdox
söliixü	soliːx
söligenexü	soliɡnox
sölilǰexü	solilʤix
sölirdexü	solirdox
söllexü	sollox
sösölexü	soslox
sösötöxü	sostox
södeixü	sodoix
södegenexü	sodoɡnox
södelǰexü	sodolʤix
södörgetüxü	sodroɡtox
sörölexü	sorlox
sörxü	sorox
sörgeülexü	sorɡuːləx
sörgeüčexü	sorɡuːʧix
sörgexü	sorɡox
süixelexü	suixləx
süilexilexü	suilxiːləx
süilexü	suiləx
süileglexü	suiləɡləx
süilxü	suiləx
süitügenexü	suitəɡnəx
süitülǰexü	suitəlʤix
süidxexü	suitɡəx
süidxü	suidəx
süirexü	suirəx
sündelexü	sundləx
sünderlexü	sundərləx
süŋginexü	suŋɡənəx
sübegčilexü	subəɡʧləx~sobəɡʧləx
sübelexü	subləx~soblox
süxelexü	suxləx
süxedexü	suxdəx
sügleixü	suɡliːx
sümeixü	suːmiːx
sümegenexü	suːməɡnəx
sümegerdexü	suːmɡərdəx
sümelǰexü	suːməlʤix
sümbüdexü	sumbədəx~sombodox
sümbürlexü	sumbərləx~somborlox
sülexü	suːləx
sülbexü	sulbəx~solbox
sülbegelexü	sulbəːləx~solboːlox
sülbegeleldüxü	sulbəːləldəx~solboːloldox
sülbegeldüxü	sulbəːldəx~solboːldox
sülǰelexü	sulʤləx
sülǰixü	sulʤix
sülǰigürlexü	sulʤuːrləx
sülǰildüxü	sulʤildəx
sülǰiyelexü	sulʤəːləx
süsüglexü	susəɡləx
südexü	suːdəx
süǰiglexü	suʤiɡləx
süyelexü	sujəːləx
süyügelexü	sujəːləx
sürexeidexü	surxeːdəx
sürexü	surəx
süreldüxü	surəldəx
süriyetüxü	surjəːtəx
sürüglexü	surəɡləx
sürügǰixü	surəɡʤix
sürxirexü	surxrəx
sürdexü	surdəx
sürdegdexü	surdəɡdəx
sürdegülxü	surduːləx
sürčixü	surʧix
sürčiginexü	surʧiɡnəx
slawčilaxu	slɑːwʧlɑx
šansadaxu	ʃɑnsdɑx
šančaglaxu	ʃɑːnʧɪɡlɑx
šanǰadaxu	ʃɑnʣdɑx
šanzidaxu	ʃɑnʣdɑx
šaŋnaixu	ʃɑɡnɪːx
šaŋnaxu	ʃɑɡnɑx
šaŋxulaxu	ʃɑŋxlɑx
šaŋdaxu	ʃɑŋdɑx
šaŋdaguraxu	ʃɑŋdʊːrɑx
šabilaxu	ʃæblɑx
šabiriyačilaxu	ʃæbrɑːʧlɑx
šabxixü	ʃɑbxiːx
šabsixu	ʃɑbʃɪx
šabsigurdaxu	ʃɑbʃʊːrdɑx
šabdaxu	ʃɑbdɑx
šagaixu	ʃɑɡæːx
šagantaglaxu	ʃɑːntɑɡlɑx
šagančaglaxu	ʃɑːnʧɪɡlɑx
šagaxitunaxu	ʃɑːxʲtnɑx
šagalaixu	ʃɑːlɪːx
šagalxu	ʃɑːlɑx
šagalčaxu	ʃɑːlʧɪx~ʃɑɡɑːlʧɪx
šagačaxu	ʃɑːʧɪx~ʃɑɡɑːʧɪx
šagaraxu	ʃɑːrɑx
šagardaxu	ʃɑːrdɑx
šagardagdaxu	ʃɑːrdɑɡdɑx
šagixu	ʃɑːɡɪx
šaglaxu	ʃɑɡlɑx
šagsixu	ʃɑɡʃɪx
šagsičixu	ʃɑɡʃʧɪx
šagsiraxu	ʃɑɡʃrɑx
šagšuurgatuxu	ʃɑɡʃʊːrɑɡtɑx
šagǰagalaxu	ʃɑɡʤɑːlɑx
šambaramtuxu	ʃɑmbɑrɑmtɑx
šambiixu	ʃæmbɪːx
šamsiixu	ʃæmʃɪːx
šamsixu	ʃæmʃɪx
šalaŋnaxu	ʃɑlɑɡnɑx
šalabalǰaxu	ʃɑlbɑlʤɪx
šalablaxu	ʃɑlɑblɑx
šalabdaxu	ʃɑlɑbdɑx
šalaxu	ʃɑlɑx
šalamagailaxu	ʃɑlmɑɡæːlɑx
šalamadaxu	ʃɑlɑmdɑx
šaladaxu	ʃɑldɑx
šalixu	ʃælɪx
šaliglaxu	ʃælɪɡlɑx
šaliyatuxu	ʃælɪɑtɑx
šaliyaraxu	ʃælɪɑrɑx
šalbiixu	ʃɑlbɪːx
šalxaixu	ʃɑlxɪːx
šalxaganaxu	ʃɑlxɡɑnɑx
šalxalǰaxu	ʃɑlxɑlʤɪx
šaldaŋnaxu	ʃɑldɑɡnɑx
šaldaŋlaxu	ʃɑldɑŋlɑx
šaldalaxu	ʃɑldlɑx
šalčiixu	ʃɑlʧɪːx
šalčiganaxu	ʃɑlʧɡɑnɑx
šalčiginaxu	ʃɑlʧɪɡnɑx
šalčilǰaxu	ʃɑlʧɪlʤɪx
šasilaxu	ʃɑʃlɑx
šatulaxu	ʃɑtlɑx
šaǰiginaxu	ʃɑʤɪɡnɑx
šaǰilaxu	ʃɑʤlɑx
šariglaxu	ʃærɪɡlɑx
šarbiginaxu	ʃærbɑɡnɑx
šarxiraxu	ʃærxrɑx
šargagaxu	ʃɑrɡɑːx
šarmiixu	ʃærmɪːx
šarčiginaxu	ʃɑrʧɪɡnɑx
šarǰiginaxu	ʃɑrʤɪɡnɑx
šeülexü	ʃuːləx
šegelexü	ʃəːləx
šelxürexü	ʃilxrəx
šiberxü	ʃibrəx
šibergenexü	ʃibrəɡnəx
širčiginexü	ʃirʧiɡnəx
šoišogčaxu	ʃœːʃɪɡʧɪx
šoolaxu	ʃɔːlɔx
šontoixu	ʃɔŋtɔɪx
šoŋnaxu	ʃɔɡnɔx
šoŋsiixu	ʃɔŋʃɪːx
šoŋsixu	ʃɔŋʃɪx
šobiginaxu	ʃœbɪɡnɔx
šoboixu	ʃɔbɔɪx
šobogonaxu	ʃɔbɡɔnɔx
šobogordaxu	ʃɔbɡɔrdɔx
šobolǰaxu	ʃɔbɔlʤɪx
šobxoixu	ʃɔbxɔɪx
šobxogonaxu	ʃɔbxɡɔnɔx
šobxolaxu	ʃɔbxlɔx
šobxolǰaxu	ʃɔbxɔlʤɪx
šobsigurlaxu	ʃɔbʃʊːrlɑx
šobsigurdaxu	ʃɔbʃʊːrdɑx
šoxogoraxu	ʃɔxɔːrɔx
šogodborilaxu	ʃɔːdbɔrlɔx
šogodxu	ʃɔːdɔx
šoglaxu	ʃɔɡlɔx
šogsixu	ʃɔɡʃɪx
šogsiraxu	ʃɔɡʃrɔx
šogšoilgaxu	ʃɔɡʃɪːlɡɔx
šogšoxu	ʃɔɡʃɪx
šomoixu	ʃɔmɔɪx
šomboixu	ʃɔmbɔɪx
šombogonaxu	ʃɔmbɔɡɔnɔx
šombogordaxu	ʃɔmbɔɡɔrdɔx
šombolǰaxu	ʃɔmbɔlʤɪx
šoloixu	ʃɔlɔɪx
šolboixu	ʃɔlbɔɪx
šolxoixu	ʃɔlxɔɪx
šolxogonaxu	ʃɔlxɡɔnɔx
šolxogolǰaxu	ʃɔlxɡɔlʤɪx
šoldoixu	ʃɔldɔɪx
šolčiixu	ʃɔlʧɪːx
šolčiginaxu	ʃɔlʧɪɡnɔx
šodaxu	ʃɔːdɔx
šodoixu	ʃɔdɔɪx
šodoxu	ʃɔdɔx
šodogonaxu	ʃɔdɡɔnɔx
šodolǰaxu	ʃɔdɔlʤɪx
šodlaxu	ʃɔdlɔx
šoǰiixu	ʃɔʤɪːx
šoǰigardaxu	ʃɔʤɡɔrdɔx
šoǰiginaxu	ʃɔʤɪɡnɔx
šoroŋlaxu	ʃɔrɔŋlɔx
šorolaxu	ʃɔrlɔx
šorodaxu	ʃɔrdɔx
šorbiixu	ʃœrbɪːx
šorboixu	ʃɔrbɔɪx
šorboilgaxu	ʃɔrbɔɪlɡɔx
šorboglaxu	ʃɔrbɔɡlɔx
šorbogǰixu	ʃɔrbɔɡʤɪx
šorxiraxu	ʃœrxrɔx
šorčiginaxu	ʃɔrʧɪɡnɔx
šorǰiginaxu	ʃɔrʤɪɡnɔx
šuuxinaxu	ʃʊːxʲnɑx
šuuxinatuxu	ʃʊːxɪntɑx
šuuxitunaxu	ʃʊːxʲtnɑx
šuuxiraxu	ʃʊːxʲrɑx
šuuginaxu	ʃʊːɡʲnɑx
šuugixu	ʃʊːɡɪx
šuugilduxu	ʃʊːɡɪldɑx
šuugičixu	ʃʊːɡʲʧɪx
šuumasalaxu	ʃʊːmɑːslɑx
šuudaxu	ʃʊːdɑx
šuŋbaxu	ʃʊmbɑx
šuŋginaxu	ʃʊŋɡɪnɑx
šuŋguxu	ʃʊŋɡɑx
šuŋgulaxu	ʃʊŋɡɑlɑx
šuŋgučixu	ʃʊŋɡɑʧɪx
šubtuixu	ʃʊbtɪːx
šubtuganaxu	ʃʊbtɡɑnɑx
šubtugardaxu	ʃʊbtɡɑrdɑx
šubtulǰaxu	ʃʊbtɑlʤɪx
šuxuixu	ʃʊːxɪːx
šuxugardaxu	ʃʊːxɡɑrdɑx
šuguxu	ʃʊːx
šugumnaxu	ʃʊɡɑmnɑx
šugumdaxu	ʃʊɡɑmdɑx
šumaixu	ʃʊmɪːx
šumagailaxu	ʃʊmɡæːlɑx
šumagaidaxu	ʃʊmɡæːdɑx
šumbaxu	ʃʊmbɑx
šuluxu	ʃʊlɑx
šuluganaxu	ʃʊlɡɑnɑx
šulgulxu	ʃʊlɡɑlɑx
šulguraxu	ʃʊlɡɑrɑx
šusinaxu	ʃʊʃnɑx
šudaglaxu	ʃʊːdɑɡlɑx
šudučixu	ʃʊdʧɪx
šudurxu	ʃʊdrɑx
šuwasadaxu	ʃʊɑsdɑx
šuwaǰadaxu	ʃʊɑʣdɑx
šöntöixü	ʃontoix
šöböixü	ʃoboix
šöbögerdexü	ʃobɡordox
šöbölǰexü	ʃobolʤix
šöbxeixü	ʃobxoix
šömöixü	ʃomoix
šömböixü	ʃomboix
šömbögerdexü	ʃomboɡordox
šölölexü	ʃollox
šölösixü	ʃolʃix
šörböixü	ʃorboix
šörgelexü	ʃoroɡlox
šüŋginexü	ʃuŋɡənəx
šüglüdexü	ʃuɡəldəx
šügüilexü	ʃuːɡuiləx
šügüxü	ʃuːx
šügügdexü	ʃuːɡdəx
šügürexü	ʃuːrəx
šügürdexü	ʃuːrdəx
šülxügetüxü	ʃulxəːtəx
šülxütüxü	ʃulxtəx
šültüxü	ʃultəx
šürxeidexü	ʃuːrxeːdəx
šürgüxü	ʃurɡəx~ʃorɡox
šürgügexü	ʃurɡəːx~ʃorɡoːx
taibaixu	tæːbɪːx
taibaganaxu	tæːbɡɑnɑx
taibusiraxu	tæːbʃrɑx
taibusiragulxu	tæːbʃrʊːlɑx
taixu	tæːx
taigalaxu	tæːɡɑlɑx
tailugdaxu	tæːlɑɡdɑx
tailburilaxu	tæːlbɑrlɑx
tailxu	tæːlɑx
taisxuraxu	tæːsɡɑrɑx
taitaganaxu	tæːtɡɑnɑx
taitalǰaxu	tæːtɑlʤɪx
taidxuraxu	tæːtɡɑrɑx
taidxuragulxu	tæːtɡɑrʊːlɑx
taičixu	tæːʧɪx
tairaixu	tæːrɪːx
tairaganaxu	tæːrɡɑnɑx
tairalǰaxu	tæːrɑlʤɪx
taulaičilaxu	tʊːlæːʧlɑx
tanixu	tænɪx
tanimagairaxu	tænɪmɡæːrɑx
tanimagairxaxu	tænɪmɡæːrxɑx
tanilčaxu	tænɪlʧɪx
tanilčagulxu	tænɪlʧʊːlɑx
tanirlaxu	tænɪrlɑx
tanuxu	tɑnɑx
tantaixu	tɑntɪːx
tanclaxu	tɑnʦlɑx
taŋnailaxu	tɑɡnæːlɑx
taŋnaisixu	tɑɡnæːʃɪx
taŋnaituxu	tɑɡnæːtɑx
taŋnairagulxu	tɑɡnæːrʊːlɑx
taŋnaxu	tɑɡnɑx
taŋxaixu	tɑŋxæːx
taŋxairaxu	tɑŋxæːrɑx
taŋxilaxu	tæŋxlɑx
taŋxilǰaxu	tæŋxɪlʤɪx
taŋxidaxu	tæŋxdɑx
taŋgaixu	tɑŋɡæːx
taŋgalǰaxu	tɑŋɡɑlʤɪx
taŋgadaxu	tɑŋɡɑdɑx
taŋgačixu	tɑŋɡɑʧɪx
taŋgariglaxu	tɑŋɡɑrɑɡlɑx
taŋgarxu	tɑŋɡɑrɑx
taŋsixu	tɑŋʃɪx
taŋsuglaxu	tɑŋsɑɡlɑx
taŋdaxu	tɑŋdɑx
tabaxaituxu	tɑbxæːtɑx
tabaxaidaxu	tɑbxæːdɑx
tabaglaxu	tɑbɑɡlɑx
tabalaxu	tɑblɑx
tabaraŋdaxu	tɑbrɑŋdɑx
tabaraxu	tɑbrɑx
tabaragadaxu	tɑbrɑːdɑx
tabarčaxu	tɑbɑrʧɪx
tabarčaglaxu	tɑbɑrʧɪɡlɑx
tabixu	tæbɪx
tabiglaxu	tæbɪɡlɑx
tabisilaxu	tæbʃlɑx
tabugasulaxu	tɑbɑːslɑx
tabulaxu	tɑblɑx
tabxaixu	tɑbxɪːx
tabxaganaxu	tɑbxɡɑnɑx
tabxalǰaxu	tɑbxɑlʤɪx
tablaxu	tɑblɑx
tabsaixu	tɑbsɪːx
tabsaganaxu	tɑbsɡɑnɑx
tabsaglaxu	tɑbsɑɡlɑx
tabsalǰaxu	tɑbsɑlʤɪx
tabsixu	tɑbʃɪx
tabragdaxu	tɑbrɑɡdɑx
taxaixu	tɑːxɪːx
taxaganaxu	tɑːxɡɑnɑx
taxalaxu	tɑxlɑx
taxalǰaxu	tɑːxɑlʤɪx
taxiixu	tæxɪːx
taxiilgaxu	tæxɪːlɡɑx
taxixu	tæxɪx
taximdaxu	tæxɪmdɑx
taxilgalaxu	tæxlɑɡlɑx
taxilǰaxu	tæxɪlʤɪx
taxiraxu	tæxrɑx
taxiragulxu	tæxrʊːlɑx
taxirlaxu	tæxɪrlɑx
taxulidxu	tɑxɑltɑx
taxulsixu	tɑxɑlʃɪx
taxultuxu	tɑxɑltɑx
tagaburilaxu	tɑːbɑrlɑx
tagaxu	tɑːx
tagamaglaxu	tɑːmɑɡlɑx
tagamalaxu	tɑːmlɑx
tagalaxu	tɑːlɑx
tagalamǰilaxu	tɑːlɑmʤlɑx
tagalčaxu	tɑːlʧɪx
tagasiyaxu	tɑːʃɑːx
tagadaixu	tɑːdɪːx
tagadaganaxu	tɑːdɡɑnɑx
tagadalǰaxu	tɑːdɑlʤɪx
tagačixu	tɑːʧɪx
tagačigulxu	tɑːʧʊːlɑx
tagaǰalaxu	tɑːʤlɑx
tagaraxu	tɑːrɑx
tagaragulxu	tɑːrʊːlɑx
tagaralduxu	tɑːrɑldɑx
tagarixu	tæːrɑx
tagarxu	tɑːrɑx
tagarlaxu	tɑːrlɑx
tagarčuglaxu	tɑːrʧɪɡlɑx
taguburilaxu	tʊːbɑrlɑx
taguburisixu	tʊːbɑrʃɪx
taguburidaxu	tʊːbɑrdɑx
taguxu	tʊːx
tagulxu	tʊːlɑx
taglaixu	tɑɡlɪːx
taglaxu	tɑɡlɑx
taglaraxu	tɑɡlɑrɑx
tagsixu	tɑɡʃɪx
tagsigurdaxu	tɑɡʃʊːrdɑx
tagtasixu	tɑɡtɑʃɪx
tagdaixu	tɑɡdɪːx
tagdaxu	tɑɡdɑx
tagdaganaxu	tɑɡdɡɑnɑx
tagdagčaxu	tɑɡdɑɡʧɪx
tagdalǰaxu	tɑɡdɑlʤɪx
tagǰiixu	tɑɡʤɪːx
tagǰixu	tɑɡʤɪx
tagǰiganaxu	tɑɡʤɡɑnɑx
tagǰilǰaxu	tɑɡʤɪlʤɪx
tagǰiraxu	tɑɡʤrɑx
tamaxilaxu	tæmɑxlɑx
tamaxidaxu	tæmɑxdɑx
tamaxu	tɑmɑx
tamagalaxu	tɑmɡɑlɑx
tamalaxu	tɑmlɑx
tamarixu	tæmrɑx
tamarigulxu	tæmrʊːlɑx
tamirdaxu	tæmɪrdɑx
tamirǰixu	tæmɪrʤɪx
tamirǰigulxu	tæmɪrʤʊːlɑx
tamuxu	tɑmɑx
tamulaxu	tɑmlɑx
tambaraxu	tɑmbɑːrɑx
tamsiyaxu	tɑmʃɑːx
tamsiyalaxu	tɑmʃɑːlɑx
tamtarixu	tæmtrɑx
tamtuglaxu	tɑmtɑɡlɑx
tamtulxu	tɑmtlɑx
tamtučixu	tɑmtʧɪx
tamturaxu	tɑmtrɑx
talaxu	tɑlɑx
talalaxu	tɑllɑx
talastuxu	tɑlstɑx
talastuǰigulxu	tɑlsɑtʤʊːlɑx
talačaxu	tɑlʧɪx
talaraxu	tɑlrɑx
talarxaxu	tɑlɑrxɑx
taliixu	tɑlɪːx
taliraxu	tælrɑx
talbixu	tæbɪx
talbigulxu	tæbʊːlɑx
talbiguraxu	tæbʊːrɑx~tælbʊːrɑx
talbigdaxu	tæbɪɡdɑx
talbiraxu	tælɪbrɑx
talxalaxu	tɑlxlɑx
talxadaxu	tɑlxdɑx
talxixu	tælxɪx
talxigdaxu	tælxɪɡdɑx
talxidaxu	tælxdɑx
talmiyatuxu	tælmɑːtɑx
talmiyaraxu	tælmɑːrɑx
taltarixu	tæltrɑx
tasamalaxu	tɑsɑmlɑx
tasamadaxu	tɑsɑmdɑx
tasixu	tɑʃɪx
tasigulaxu	tɑʃʊːlɑx
tasigulxu	tɑʃʊːlɑx
tasiguraxu	tɑʃʊːrɑx
tasigurdaxu	tɑʃʊːrdɑx
tasimagailaxu	tɑʃɪmɡæːlɑx
tasilaxu	tɑʃlɑx~dɑʃlɑx
tasilxilaxu	tɑʃɪlxiːləx
tasiyalaxu	tɑʃɑːlɑx
tasiyalagdaxu	tɑʃɑːlɑɡdɑx
tasiyaldaxu	tɑʃɑːldɑx
tasiyaraxu	tɑʃɑːrɑx
tasiramdaxu	tɑʃrɑmdɑx~dɑʃrɑmdɑx
tasirlaxu	tɑʃɪrlɑx
tasulxu	tɑslɑx
tasuldaxu	tɑsɑldɑx
tasudaxu	tɑsdɑx
tasuraxu	tɑsrɑx
tasxixü	tɑsxiːx
tatabalǰaxu	tɑtbɑlʤɪx
tataburilaxu	tɑtbɑrlɑx
tataxu	tɑtɑx
tataganaxu	tɑtɡɑnɑx
tatagalǰaxu	tɑtɡɑlʤɪx
tataguraxu	tɑtʊːrɑx
tatagdaxu	tɑtɑɡdɑx
tatalaxu	tɑtlɑx
tatalgaxu	tɑtɑlɡɑx
tatalgalaxu	tɑtlɑɡlɑx
tatalduxu	tɑtɑldɑx
tataraxu	tɑtrɑx
tačiginaxu	tɑʧɪɡnɑx
tačiyaxu	tɑʧɑːx
tačiyadaxu	tɑʧɑːdɑx
tačirdaxu	tɑʧɪrdɑx
taǰiixu	tɑʤɪːx
taǰiginaxu	tɑʤɪɡnɑx
tayaglaxu	tɑjɪɡlɑx
tayagdaxu	tɑjɪɡdɑx
taraixu	tɑrɪːx
taraxu	tɑrɑx
taragaxu	tɑrɑːx
taraglaxu	tɑrɑɡlɑx
taragsixu	tɑrɑɡʃɪx
taramagdaxu	tɑrmɑɡdɑx
tarixilaxu	tærxlɑx
tarixidaxu	tærxdɑx
tarixu	tærɪx
tariyalaxu	tærɪɑlɑx
tarnidaxu	tærɪndɑx
tarbagalaxu	tɑrbɑɡlɑx
tarbagačaxu	tɑrbɑɡʧɪx
tarbagačilaxu	tɑrbɑɡʧlɑx
tarbalǰaxu	tɑrbɑlʤɪx
tarbixu	tærbɑx
tarxaxu	tɑrxɑx
tarxagaxu	tɑrxɑːx
targulaxu	tɑrɡɑlɑx
targulagulxu	tɑrɡɑlʊːlɑx
targudaxu	tɑrɡɑdɑx
tarmaxu	tɑrmɑx
tarmagurdaxu	tɑrmʊːrdɑx
tarmiixu	tærmɪːx
tarlantuxu	tɑrlɑntɑx
tarlaxu	tɑrlɑx
tarsixu	tɑrʃɪx
tardaxu	tɑrdɑx
tarčiginaxu	tɑrʧɪɡnɑx
tarčigdaxu	tɑrʧɪɡdɑx
tarčilaxu	tɑrʧlɑx
tarčilagaxu	tɑrʧɪlɡɑx
tarčilǰaxu	tɑrʧɪlʤɪx
tawarčilaxu	tɑwɑːrʧlɑx
teilexü	tiːləx
teiseldüxü	tiːsəldəx
teisilexü	tiːʃləx
teičixü	tiːʧix
teičiginexü	tiːʧiɡnəx
teičilexü	tiːʧləx
teiǰedexü	tiːʣdəx
teirxü	tiːrəx
teirgelexü	tiːrəɡləx
teüxečilexü	tuːxʧləx
teneglexü	tənəɡləx
tenegtüxü	tənəɡtəx
tenegrexü	tənəɡrəx
teniixü	təniːx
teniilgexü	təniːlɡəx
tenüxü	tənəx
tenügüčilexü	tənuːʧləx
tenügürexü	tənuːrəx
tenteixü	təntiːx
tenteilexü	təntiːləx
tentegenexü	təntəɡnəx
tentelǰexü	təntəlʤix
tenčigürexü	tənʧuːrəx
tenčirexü	tənʧrəx
tenǰixü	tənʤix~tənʧix
teŋnexü	təɡnəx
teŋnegürdexü	təɡnuːrdəx
teŋxexü	təŋxəx
teŋxegedexü	təŋxəːdəx
teŋxeǰixü	təŋxʤix
teŋxerexü	təŋxrəx
teŋxeregülxü	təŋxruːləx
teŋgexü	təŋɡəx
teŋgečexü	təŋɡəʧix
teŋgürxü	təŋɡərəx
teŋsexü	təŋsəx
teŋčexü	təŋʧix
teŋčegülxü	təŋʧuːləx
teŋčegürilexü	təŋʧuːrləx
teŋčedxexü	təŋʧitɡəx
teŋčedxü	təŋʧtəx
teŋǰilexü	təŋʤləx
tebegelexü	təbəːləx
tebegerexü	təbəːrəx
tebegeregülxü	təbəːruːləx
tebedexü	təbdəx
tebedegülxü	təbduːləx
teberixü	təbrəx
teberildüxü	təbrəldəx
teberilčexü	təbrəlʧix
tebxeixü	təbxiːx
tebxelexü	təbxləx
tebxelǰexü	təbxəlʤix
tebxedexü	təbxdəx
tebxerlexü	təbxərləx
tebčixü	təbʧix
tebčiyerilexü	təbʧəːrləx
texerexü	təxrəx
tegsilexü	təɡʃləx
tegsidexü	təɡʃdəx
tegsidxexü	təɡʃitɡəx
tegsidxü	təɡʃtəx
tegsirexü	təɡʃrəx
tegsiregülxü	təɡʃruːləx
tegdeixü	təɡdiːx
tegdegenexü	təɡdəɡnəx
tegdelǰexü	təɡdəlʤix
tegeneglexü	təːnəɡləx
tegexü	təɡəx
tegeglexü	təːɡləx
tegegebürilexü	təːbərləx
tegegexü	təːx
tegegeresiyexü	təːrʃəːx
tegedexü	təːdəx
tegerexü	təːrəx
tegermedexü	təːrəmdəx
tegübürilexü	tuːbərləx
tegüxü	tuːx
tegülderǰixü	toɡoldorʤix
tegülderǰigülxü	toɡoldorʤuːləx
tegüsxexü	toɡsɡox
tegüsxü	toɡsox
tegüdegerexü	tuːdəːrəx
tegüderexü	tuːdrəx
tegüderxexü	tuːdərxəx
temeülxü	təmuːləx
temexü	təməx
temegečilexü	təməːʧləx
temegeǰixü	təməːʤix
temečexü	təmʧix
temečeldüxü	təmʧildəx
temürlexü	tomorlox
tembürexü	təmbuːrəx
temterixü	təmtrəx
temterxilexü	təmtərxiːləx
temdeglexü	təmdəɡləx
temdegrexü	təmdəɡrəx
teleilexü	təliːləx
teleülxü	təluːləx
teleürexü	təluːrəx
telexü	tələx
telegelexü	tələːləx
telegürdexü	təluːrdəx
telemexü	təlməx
telerexü	təlrəx
telčiginexü	təlʧiɡnəx
telčilexü	təlʧləx
tesergülexü	təsrəɡləx
tesixü	təʃix
tesigürdexü	təʃuːrdəx
tesilexü	tiːʃləx
tesülxü	təsləx
tesürexü	təsrəx
tesüregülxü	təsruːləx
tesbürilexü	təsbərləx
tesxeixü	təsɡiːx
tesxexü	təsɡəx
tesxixü	təsxiːx
tesxü	təsəx
tetegeilexü	tətɡiːləx
tedxübürilexü	tətɡəbərləx
tedxüxü	tətɡəx
tedxümǰilexü	tətɡəmʤləx
tedxülčexü	tətɡəlʧix
teǰigebüriǰigülxü	təʤəːbərʤuːləx
teǰigexü	təʤəːx
teǰigelgexü	təʤəːlɡəx
teǰiyexü	təʤəːx
tereixü	təriːx
terigülexü	tərɡuːləx
tergelexü	tərəɡləx
tergellexü	tərɡəlləx
terlexü	tərləx
terslexü	tərsləx
tersdexü	tərsdəx
terčiginexü	tərʧiɡnəx
tiglexü	tiɡləx
titimlexü	titəmləx
tirčiginaxu	tɪrʧɪɡnɑx
toibisiyaxu	tœːbʃɔːx
toiglaxu	tœːɡlɔx
toimogčilaxu	tœːmɔɡʧlɔx
toimolaxu	tœːmlɔx
toimočilaxu	tœːmʧlɔx
toilaxu	tœːlɔx
tooslaxu	tɔːslɔx
toorailaxu	tɔːrœːlɔx
toorlaxu	tɔrlɔx
toordaxu	tɔrdɔx
tonilxu	tœnlɔx
tonilgaxu	tœnɪlɡɔx
tonoxu	tɔnɔx
tonoglaxu	tɔnɔɡlɔx
tonolǰilaxu	tɔːnɔlʤlɔx
tontoixu	tɔntɔɪx
tontogonaxu	tɔntɡɔnɔx
tontolǰaxu	tɔntɔlʤɪx
tonǰiraxu	tɔnʤrɔx
toŋgoixu	tɔŋɡɔɪx
toŋgoilgaxu	tɔŋɡɔɪlɡɔx
toŋgolǰaxu	tɔŋɡɔlʤɪx
toŋgoraxu	tɔŋɡɔrɔx
toŋgoragaxu	tɔŋɡɔrɔːx
toŋgoragulxu	tɔŋɡɔrʊːlɑx
toŋgorčaxu	tɔŋɡɔrʧɪx
toŋgorčaglaxu	tɔŋɡɔrʧɪɡlɔx
toŋsixu	tɔŋʃɪx
toŋsilxilaxu	tɔŋʃɪlxiːləx
tobixu	tœbɪx
toboixu	tɔbɔɪx
tobogonaxu	tɔbɡɔnɔx
tobogordaxu	tɔbɡɔrdɔx
tobolǰaxu	tɔbɔlʤɪx
tobxixu	tœbxɪx
tobxoixu	tɔbxɔɪx
tobxogordaxu	tɔbxɡɔrdɔx
tobxolaxu	tɔbxlɔx
tobxodoxu	tɔbxtɔx
toblaxu	tɔblɔx
tobsixu	tɔbʃɪx
tobsigurdaxu	tɔbʃʊːrdɑx
tobsilaxu	tɔbʃlɔx
tobčixu	tɔbʧɪx
tobčiginaxu	tɔbʧɪɡnɔx
tobčigulxu	tɔbʧʊːlɑx
tobčilaxu	tɔbʧlɔx
tobčidaxu	tɔbʧdɔx
tobčiyaxu	tɔbʧɔːx
tobčiyalaxu	tɔbʧɔːlɔx
tobčiragutuxu	tɔbʧrʊːtɑx
tobǰiginaxu	tɔbʤɪɡnɔx
tobraglaxu	tɔbrɔɡlɔx
tobragdaxu	tɔbrɔɡdɔx
toxiixu	tœxɪːx
toxixu	tœxɪx
toxičaxu	tœxʧɪx
toxiyaxu	tœxɪɔx
toxiyalgaxu	tœxɪɔlɡɔx
toxiyalduxu	tœxɪɔldɔx
toxiyaldugulxu	tœxɪɔldʊːlɑx
toxiraxu	tœxrɔx
toxiragulxu	tœxrʊːlɑx
toxiralčaxu	tœxrɔlʧɪx
toxoixu	tɔxœːx
toxoilaxu	tɔxœːlɔx
toxoildaxu	tɔxœːldɔx
toxoidaxu	tɔxœːdɔx
toxoiraxu	tɔxœːrɔx
toxonixu	tœxnɔx
toxonigulxu	tœxnʊːlɑx
toxoxu	tɔxɔx
toxogaxu	tɔxɔːx
toxoguraxu	tɔxʊːrɑx
toxogurxaxu	tɔxʊːrxɑx
toxomlaxu	tɔxɔmlɔx
toxosilaxu	tɔxʃlɔx
toxorogulxu	tɔxrʊːlɑx
toxorxu	tɔxrɔx
togalaxu	tɔːlɔx
togačaxu	tɔːʧɪx
togačagalaxu	tɔːʧɔːlɔx
togačixu	tɔːʧɪx
togonolǰilaxu	tɔːnɔlʤlɔx
togonočaxu	tɔːnʧɪx
togonočilaxu	tɔːnʧlɔx
togoxu	tɔːx
togogalaxu	tɔɡɔːlɔx
togogoxu	tɔːx
togomlaxu	tɔːmlɔx
togomsaraxu	tɔːmsrɔx
togomsarxaxu	tɔːmsɔrxɔx
togomsarlaxu	tɔːmsɔrlɔx
togosotoxu	tɔːstɔx
togosoraxu	tɔːsrɔx
togočaxu	tɔːʧɪx
togoriŋxaituxu	tœːrɔŋxœːtɔx
togorixu	tœːrɔx
togorigulxu	tœːrʊːlɑx
togoriglaxu	tœːrɔɡlɔx
toglaxu	tɔɡlɔx
togloixu	tɔɡlɔɪx
togsixu	tɔɡʃɪx
togsiyaxu	tɔɡʃɔːx
togtanixu	tɔɡtnɔx
togtanigulxu	tɔɡtnʊːlɑx
togtaŋgiǰixu	tɔɡtɔŋɡɪʤɪx
togtaŋgiraxu	tɔɡtɔŋɡɪrɔx
togtaŋguiraxu	tɔɡtɔŋɡʊɪrɑx
togtaburilaxu	tɔɡtbɔrlɔx
togtaburiǰixu	tɔɡtbɔrʤɪx
togtaburiǰigulxu	tɔɡtbɔrʤʊːlɑx
togtaxu	tɔɡtɔx
togtagaxu	tɔɡtɔːx
togdoixu	tɔɡdɔɪx
togdogonaxu	tɔɡdɡɔnɔx
togdogordaxu	tɔɡdɡɔrdɔx
togdolǰaxu	tɔɡdɔlʤɪx
tomilaxu	tœmlɔx
tomiyalaxu	tɔmjɔːlɔx
tomiyačilaxu	tɔmjɔːʧlɔx
tomoixu	tɔmɔɪx
tomoxu	tɔmɔx
tomogaǰixu	tɔmɔːʤɪx
tomogaraxu	tɔmɔːrɔx
tomogarxaxu	tɔmɔːrxɔx
tomogolaxu	tɔmɔːlɔx~tɔmɡɔlɔx
tomoguraxu	tɔmʊːrɑx
tomoglaxu	tɔmɔɡlɔx
tomodaxu	tɔmdɔx
tomodxaxu	tɔmtɡɔx
tomodxu	tɔmtɔx
tomočilaxu	tɔmʧlɔx
tomoraxu	tɔmrɔx
tomoragulxu	tɔmrʊːlɑx
tomorxaxu	tɔmɔrxɔx
tomboixu	tɔmbɔɪx
tombogordaxu	tɔmbɔɡɔrdɔx
tomǰiyalaxu	tɔmʤɔːlɔx
toliixu	tœlɪːx
toliilgaxu	tœlɪːlɡɔx
tolixu	tœlɪx
toliganaxu	tœlɡɔnɔx
toligardaxu	tœlɡɔrdɔx
tolilaxu	tœllɔx
tolilagulxu	tœllʊːlɑx
tolilǰaxu	tœlɪlʤɪx
tolidaxu	tœldɔx
tolidagulxu	tœldʊːlɑx
toliǰigulxu	tœlʤʊːlɑx
toliraxu	tœlrɔx
tologailaxu	tɔlɡœːlɔx
tolbosixu	tɔlɔbʃɪx
tolbotoxu	tɔlɔbtɔx
tolboraxu	tɔlɔbrɔx
tolxixu	tœlxɪx
tolxilčaxu	tœlxɪlʧɪx
tosiŋnaxu	tɔʃɪɡnɔx
tosiŋtoxu	tɔʃɪŋtɔx
tosoŋgitoxu	tɔsɔŋɡɪtɔx
tosolaxu	tɔslɔx
tosotoxu	tɔstɔx
tosodaxu	tɔsdɔx
tosxičixu	tɔʃɪɡʧɪx
tosxiraxu	tɔʃɪɡrɔx
tosxu	tɔsɔx
todoixu	tɔdɔɪx
todolaxu	tɔdlɔx
tododxaxu	tɔdɔtɡɔx
tododxu	tɔdtɔx
todočilaxu	tɔdʧɪlɔx
todoraxu	tɔdrɔx
todoragulxu	tɔdrʊːlɑx
todorxailaxu	tɔdɔrxœːlɔx
todxarlaxu	tɔtɡɔrlɔx
točiginaxu	tɔʧɪɡnɔx
toǰiixu	tɔʤɪːx
toǰiganaxu	tɔʤɡɔnɔx
toǰiginaxu	tɔʤɪɡnɔx
toǰilǰaxu	tɔʤɪlʤɪx
toroixu	tɔrɔɪx
toroilaxu	tɔrœːlɔx
toromtoglaxu	tɔrɔmtɔɡlɔx
toromǰilaxu	tɔrɔmʤlɔx
tornixu	tœrnɔx
tornigulxu	tœrnʊːlɑx
torbolǰaxu	tɔrbɔlʤɪx
torxu	tɔrɔx
torgaxu	tɔrɡɔx
torgoxu	tɔrɡɔx
torgoglaxu	tɔrɡɔɡlɔx
torgolǰaxu	tɔrɡɔlʤɪx
tormoixu	tɔrmɔɪx
tormogonaxu	tɔrɔmɡɔnɔx
tormolǰaxu	tɔrmɔlʤɪx
torlogdaxu	tɔrlɔɡdɔx
tortoglaxu	tɔrtɔɡlɔx
tortogdaxu	tɔrtɔɡdɔx
tordaxu	tɔrdɔx
tordogonaxu	tɔrdɡɔnɔx
torčiginaxu	tɔrʧɪɡnɔx
tuibaŋdaxu	tʊɪbɑŋdɑx
tuibaxu	tʊɪbɑx
tuibaganaxu	tʊɪbɡɑnɑx
tuibalǰaxu	tʊɪbɑlʤɪx
tuibaraxu	tʊɪbrɑx
tuiguxu	tʊɪɡɑx
tuilaxu	tʊɪlɑx
tuilsiraxu	tʊɪlʃrɑx
tuildaxu	tʊɪldɑx
tuitugunaxu	tʊɪtɡɑnɑx
tuitulǰaxu	tʊɪtɑlʤɪx
tuituraxu	tʊɪtrɑx
tuuxaičaxu	tʊːxæːʧɪx
tuulixu	tʊːlɪx
tuušlaxu	tʊːʃlɑx
tuušlagulxu	tʊːʃlʊːlɑx
tuuǰuudaxu	tʊːʤʊːdɑx
tunixu	tʊnɪx
tunirxaxu	tʊnɪrxɑx
tunuxu	tʊnɑx
tunugaxu	tʊnɡɑx
tunuraxu	tʊnrɑx
tuntaixu	tʊntɪːx
tuntaganaxu	tʊntɡɑnɑx
tuntalǰaxu	tʊntɑlʤɪx
tunǰiraxu	tʊnʤrɑx
tuŋnaxu	tʊɡnɑx
tuŋxaglaxu	tʊŋxɑɡlɑx
tuŋxu	tʊnɑx
tuŋgaxu	tʊŋɡɑːx
tuŋgalagsixu	tʊŋɡɑlɑɡʃɪx
tuŋšuusalaxu	tʊŋʃʊːslɑx
tuxailaxu	tʊxæːlɑx
tuxalaxu	tʊxlɑx
tuxirxu	tʏxrɑx
tugulxu	tʊːlɑx
tugulgaxu	tʊːlɡɑx
tugulgadaxu	tʊɡlɑɡdɑx
tugullaxu	tʊɡɑllɑx
tugusilaxu	tʊːʃlɑx
tugurailaxu	tʊːræːlɑx
tuguraxu	tʊːrɑx
tugurbixu	tʊːrbɪx
tugurgalaxu	tʊːrɡɑlɑx
tumalaxu	tʊmlɑx
tumarxaxu	tʊmɑrxɑx
tumbaixu	tʊmbɪːx
tumbaganaxu	tʊmbɑɡɑnɑx
tumbagardaxu	tʊmbɑɡɑrdɑx
tumbalaidaxu	tʊmbɑlæːdɑx
tumbalǰaxu	tʊmbɑlʤɪx
tumlaidaxu	tʊmlæːdɑx
tulaituxu	tʊlæːtɑx
tulairaxu	tʊlæːrɑx
tulixu	tʊlɪx
tulugasulaxu	tʊlɑːslɑx
tulugurdaxu	tʊlʊːrdɑx
tulumlaxu	tʊlɑmlɑx
tululduxu	tʊlɑldɑx
tululčaxu	tʊlɑlʧɪx
tulxu	tʊlɑx
tulgaxu	tʊlɡɑx
tulgagurilaxu	tʊlɡʊːrlɑx
tulgagurlaxu	tʊlɡʊːrlɑx
tulgagurdaxu	tʊlɡʊːrdɑx
tulgamdaxu	tʊlɡɑmdɑx
tulgaraxu	tʊlɡɑrɑx
tulgardaxu	tʊlɡɑrdɑx
tulmaidaxu	tʊlmæːdɑx
tulduidxu	tʊldɪːdɑx
tusagarlaxu	tʊsɡɑːrlɑx
tusagardaxu	tʊsɡɑːrdɑx
tusalaxu	tʊslɑx
tusixu	tʊʃɪx
tusiyaxu	tʊʃɑːx
tusiyalduxu	tʊʃɑːldɑx
tusxailaxu	tʊsɡæːlɑx
tusxaiǰigulxu	tʊsɡæːʤʊːlɑx
tusxairaxu	tʊsɡæːrɑx
tusxaxu	tʊsɡɑx
tusxu	tʊsɑx
tušaxu	tʊʃɪx
tuǰaraxu	tʊʤrɑx
tuyagalaxu	tʊjɑːlɑx
tuyagaraxu	tʊjɑːrɑx
tuyačixu	tʊjʧɪx
turaŋxaidaxu	tʊrɑŋxæːdɑx
turaŋgidaxu	tʊrɑŋɡɪdɑx
turaxu	tʊrɑx
turagaxu	tʊrɑːx
turugulaxu	tʊrʊːlɑx
turbixu	tʏrbɑx
turgixu	tʊrɡɪx
tursixu	tʊrʃɪx
töŋxixü	toŋxox
töbedčilexü	tobdʧilox
töböixü	toboix
töböntöxü	tobontox
töböŋtöxü	toboŋtox
töbögenexü	toboɡnox
töbögerdexü	tobɡordox
töbölǰexü	tobolʤix
töbxinexü	tobxnox~tuxnəx
töbxinegülxü	tobxnuːləx~tuxnuːləx
töblexü	toblox
töblerexü	toblorox
töbleregülxü	tobloruːləx
töxögerexü	toxoːrox
töxögerxü	toxoːrox
tögenexü	toːnox
tögenerexü	toːnrox
tögelexü	toːlox
tögeriŋxeitüxü	toːroŋxøːtox
tögerixü	toːrox
tögerigdexü	toːroɡdox
tögerigülxü	toːruːləx
tögöriglexü	toɡroɡlox
tögörigelexü	toɡroːlox
tömböixü	tomboix
tömbögenexü	tomboɡnox
tömbölǰexü	tombolʤix
tölöblexü	toloblox
tölöblegeǰixü	tolobloɡʤix~tolobloɡoːʤix
tölöblegeǰigülxü	tolobloɡʤuːləx~tolobloɡoːʤuːləx
tölöbsirexü	tolobʃrox
tölöbǰixü	tolobʤix
tölöbǰigülxü	tolobʤuːləx
tölöxü	tolox
tölögelexü	toloːlox
tölögesülexü	toloːslox
tölöǰixü	tolʤix
tölöǰirexü	tolʤrox
tölgedexü	toloɡdox
töllexü	tollox
tölǰixü	tolʤix
tösöblexü	tosoblox
tösögelexü	tosoːlox
tösxü	tosox
töslexü	toslox
töröxü	torox
törögdexü	toroɡdox
törögdegülxü	toroɡduːləx
törögülxü	toruːləx
törxömlexü	torxomlox
törxömsexü	torxomsox
törxömčilexü	torxomʧlox
törxöǰixü	torxʤix
tüibexü	tuibəx
tüibegexü	tuibəːx
tüibegülxü	tuibuːləx
tüibergexü	tuibərɡəx
tüimerdexü	tuimərdəx
tüidxerlexü	tuitɡərləx
tüidxü	tuidəx
tünerexü	tunrəx
tünertüxü	tunərtəx
tünüidexü	tuniːdəx
tüntüixü	tuntiːx
tüntügenexü	tuntəɡnəx
tüntügünexü	tuŋtəɡnəx
tüntülǰexü	tuntəlʤix
tüŋxüixü	tuŋxiːx
tüŋxügenexü	tuŋxəɡnəx
tüŋxülǰexü	tuŋxəlʤix
tüŋgerčeglexü	tuŋɡərʧiɡləx
tüŋsixü	tuŋʃix
tüŋsigürdexü	tuŋʃuːrdəx
tüŋsilexü	tuŋʃləx
tüŋsüixü	tuŋsiːx
tübenexü	tubnəx~tobnox
tübexü	tubəx~tobox
tübeglexü	tubəɡləx~toboɡlox
tübegsixü	tubəɡʃix~toboɡʃix
tübegsiyexü	tubəɡʃəːx~toboɡʃoːx
tübegdexü	tubəɡdəx~toboɡdox
tüberxü	tubrəx
tübsidxexü	tubʃitɡəx
tübsidxü	tubʃtəx
tübsirexü	tubʃrəx
tübdexü	tubdəx
tüxeirexü	tuːxeːrəx
tügsexü	tuɡsəx
tügsixü	tuɡʃix
tügdečixü	tuɡdʧix
tügderexü	tuɡdrəx
tügdüixü	tuɡdiːx
tügdügenexü	tuɡdəɡnəx
tügdügünexü	tuɡdəɡnəx
tügdülǰexü	tuɡdəlʤix
tügǰiixü	tuɡʤiːx
tügǰixü	tuɡʤix
tügǰigenexü	tuɡʤiɡnəx
tügǰilǰexü	tuɡʤilʤix
tügǰirexü	tuɡʤrəx
tügexü	tuɡəx~toɡox
tügegexü	tuɡəːx~toɡoːx
tügemelǰixü	tuɡəːməlʤix~toɡoːmolʤix
tügemelǰigülxü	tuɡəːməlʤuːləx~toɡoːmolʤuːləx
tügüxeirexü	tuːxeːrəx
tügüsilexü	tuːʃləx
tügüsidexü	tuːʃdəx
tügüdeglexü	tuːdəɡləx
tügüdegtüxü	tuːdəɡtəx
tügüregsixü	tuːrəɡʃix
tümbüixü	tumbiːx
tümbügenexü	tumbəɡnəx
tümbügünexü	tumbəɡnəx
tümbülǰexü	tumbəlʤix
tülexü	tuləx
tülxixü	tulxəx
tülxigelexü	tulxəːləx
tülxilexü	tulxləx
tülxilčexü	tulxəlʧix
tülxisxixü	tulxəsxiːx
tülxiyesülexü	tulxəːsləx
tülgüxü	tulɡəx
tüsixü	tuʃix
tüsiglexü	tuʃiɡləx
tüsürxü	tusrəx
tüsürgexü	tusərɡəx
tüsxeixü	tusɡiːx
tüdexü	tudəx
tüdegexü	tudəːx
tüdegelǰexü	tudɡəlʤix
tüčiginexü	tuʧiɡnəx
tüǰiixü	tuʤiːx
tüǰirexü	tuʤrəx
tüǰirlexü	tuʤirləx
türeibčilexü	turiːbʧləx
türeilexü	turiːləx
türexü	turəx
türixü	turəx
türimexeilexü	turəmxeːləx
türimexeirxexü	turəmxeːrxəx
türilxilexü	turəlxiːləx
türidxü	turdəx
türiyesülexü	turəːsləx
türügülexü	turuːləx
türügütüxü	turuːtəx
türxixü	turxəx
türxilexü	turxləx
türgebčilexü	turɡəbʧləx
türgelexü	turəɡləx
türgesxexü	turɡəsɡəx
türgesxü	turəɡsəx
türgedexü	turəɡdəx
türgedxexü	turɡətɡəx
türgedxü	turəɡtəx
türčiginexü	turʧiɡnəx
d'eülexü	duːləx
d'ugarlaxu	dʊɡɑːrlɑx
d'üilexü	duiləx
d'üilegülxü	duiluːləx
d'üŋnexü	duɡnəx
daibaixu	dæːbɪːx
daibaxu	dæːbɑx
daibaganaxu	dæːbɡɑnɑx
daibalǰaxu	dæːbɑlʤɪx
daiburilaxu	dæːbɑrlɑx
daixu	dæːx
dailaxu	dæːlɑx
dailalduxu	dæːlɑldɑx
dailixu	dæːlɑx
daisalaxu	dæːslɑx~dæːʣlɑx
daisiyaxu	dæːʃɑːx
daisuŋnaxu	dæːsɑɡnɑx
daisulaxu	dæːslɑx
daisulalduxu	dæːslɑldɑx
daituxu	dæːtɑx
daičinǰixu	dæːʧɪnʤɪx
daičinǰigulxu	dæːʧɪnʤʊːlɑx
daičilaxu	dæːʧɪlɑx
daiǰixu	dæːʤɪx
danaixu	dɑnɪːx
danagardaxu	dɑnɡɑrdɑx
danalǰaxu	dɑnɑlʤɪx
danǰilaxu	dɑnʤlɑx
daŋnaxu	dɑɡnɑx
daŋxaixu	dɑŋxæːx
daŋxaganaxu	dɑŋxɡɑnɑx
daŋxalǰaxu	dɑŋxɑlʤɪx
daŋxiixu	dæŋxɪːx
daŋxigardaxu	dæŋxɡɑrdɑx
daŋginaxu	dæŋɡɪnɑx
daŋginagulxu	dæŋɡɪnʊːlɑx
daŋsalaxu	dɑŋslɑx
daŋdaxu	dɑŋdɑx
daŋčilaxu	dɑŋʧɪlɑx
daŋǰiyadlaxu	dɑŋʤɑːdlɑx
dabaxu	dɑbɑx
dabagadaxu	dɑbɑːdɑx
dabagulxu	dɑbʊːlɑx
dabaguraxu	dɑbʊːrɑx
dabamagailaxu	dɑbɑmɡæːlɑx
dabalxu	dɑblɑx
dabalgalaxu	dɑbɑlɡɑːlɑx
dabaraxu	dɑbrɑx
dabaragudaxu	dɑbrʊːdɑx
dabarxaidaxu	dɑbɑrxæːdɑx
dabixu	dæbɪx
dabiginaxu	dæbɪɡnɑx
dabidaraxu	dæbdrɑx
dabičixu	dæbʧɪx
dabiraxu	dæbrɑx
dabusulaxu	dɑbslɑx
dabusutuxu	dɑbstɑx
dabusuraxu	dɑbsrɑx
dabxixu	dæbxɪx
dabxilduxu	dæbxɪldɑx
dabxulaxu	dɑbxlɑx
dabxučaxu	dɑbxʧɪx
dabxučagulxu	dɑbxʧʊːlɑx
dabxučalaxu	dɑbxɑʧlɑx
dabxuralaxu	dɑbxrɑːlɑx
dabxuratuxu	dɑbxrɑːtɑx
dabxurlaxu	dɑbxɑrlɑx
dabxurdaxu	dɑbxɑrdɑx
dabsixu	dɑbʃɪx
dabsigulxu	dɑbʃʊːlɑx
dabsiguraxu	dɑbʃʊːrɑx
dabsilaxu	dɑbʃlɑx
dabtaxu	dɑbtɑx
dabtagdaxu	dɑbtɑɡdɑx
dabčigudaxu	dɑbʧʊːdɑx
dabčidaxu	dɑbʧdɑx
dabǰadaxu	dɑbʤdɑx
dabǰaraxu	dɑbʤrɑx
dabǰiginaxu	dɑbʤɪɡnɑx
daxixu	dæxɪx
daxituxu	dæːxtɑx
daxiraxu	dæːxrɑx
daxulaxu	dɑxlɑx
dagabulaxu	dɑːblɑx
dagaburilaxu	dɑɡbɑrlɑx
dagaburlaxu	dɑːbɑrlɑx
dagaxituxu	dæːxtɑx
dagaxiraxu	dæːxrɑx
dagaxu	dɑɡɑx
dagagaburilaxu	dɑːbɑrlɑx
dagagaxu	dɑːx
dagagalgaxu	dɑːlɡɑx
dagagačilaxu	dɑːʧlɑx
dagagulxu	dɑɡʊːlɑx
dagamǰiraxu	dɑːmʤrɑx
dagalaxu	dɑːɡlɑx
dagalduxu	dɑɡɑldɑx
dagaldugulxu	dɑɡɑldʊːlɑx
dagadxaxu	dɑːtɡɑx
dagačalaxu	dɑːʧlɑx
dagaǰiŋnaxu	dɑːʤɪɡnɑx
dagaraxu	dɑːrɑx
dagarixu	dæːrɑx
dagarigulxu	dæːrʊːlɑx
dagarigdaxu	dæːrɑɡdɑx
dagarilxaxu	dæːrɑlxɑx
dagarilduxu	dæːrɑldɑx
dagarilčaxu	dæːrɑlʧɪx
dagarituxu	dæːrtɑx
dagixu	dæɡɪx
dagulaxu	dʊːlɑx
dagusburilaxu	dʊːsbɑrlɑx
dagusxaxu	dʊːsɡɑx
dagusxu	dʊːsɑx
dagudaxu	dʊːdɑx
dagurilaxu	dʊːrʲlɑx
dagurisxu	dʊːrʲsɑx
daguriyaxu	dʊːrɪɑx~dʊrɑːx
dagursixu	dʊːrʃɪx
daglaixu	dɑɡlɪːx
dagsiraxu	dɑɡʃrɑx
dagtaraxu	dɑɡtrɑx
dagtarsixu	dɑɡtɑrʃɪx
dagtuxu	dɑɡtɑx
dagdaganaxu	dɑɡdɡɑnɑx
dagǰadaxu	dɑɡʤdɑx
dagǰixu	dɑɡʤɪx
dagǰiraxu	dɑɡʤrɑx
damarudaxu	dɑmbɑrʊːdɑx~dɑmɑrdɑx
damurlaxu	dɑmɑrlɑx
damnaxu	dɑmnɑx
damnagalǰaxu	dɑmnɑɡɑlʤɪx
damnagurdaxu	dɑmnʊːrdɑx
damnagdaxu	dɑmnɑɡdɑx
damnalduxu	dɑmnɑldɑx
dampuraxu	dɑmpʊːrɑx
damsaglaxu	dɑmsɑɡlɑx
damdaxu	dɑmdɑx
damǰixu	dɑmʤɪx
damǰigulxu	dɑmʤʊːlɑx
damǰigurlaxu	dɑmʤʊːrlɑx
damǰigurdaxu	dɑmʤʊːrdɑx
damǰilaxu	dɑmʤlɑx
dalaixu	dɑlæːx
dalailgaxu	dɑlæːlɡɑx
dalaŋnaxu	dɑlɑɡnɑx
dalaŋlaxu	dɑlɑŋlɑx
dalaŋdaxu	dɑlɑŋdɑx
dalabčilaxu	dɑlɑbʧlɑx
dalalxu	dɑllɑx
daliixu	dælɪːx
daliudaxu	dælɪʊdɑx
daliganaxu	dælɡɑnɑx
dalimdaxu	dælɪmdɑx
dalimdagulxu	dælɪmdʊːlɑx
dalilǰaxu	dælɪlʤɪx
dalbaixu	dɑlbɪːx
dalbaxu	dɑlbɑx
dalbaganaxu	dɑlɑbɡɑnɑx
dalbalxu	dɑlɑblɑx
dalbalǰaxu	dɑlbɑlʤɪx
dalbaraxu	dɑlɑbrɑx
dalbiixu	dælbɪːx
dalbiganaxu	dælɪbɡɑnɑx
dalbigardaxu	dælɪbɡɑrdɑx
dalbilǰaxu	dælbɑlʤɪx
daldabčilaxu	dɑldɑbʧlɑx
daldalaxu	dɑldlɑx
daldičixu	dældʧɪx
daldiraxu	dældrɑx
dalǰiixu	dɑlʤɪːx
dalǰiganaxu	dɑlʤɡɑnɑx
dalǰilǰaxu	dɑlʤɪlʤɪx
dasulčaxu	dɑsɑlʧɪx
dasxaxu	dɑsɡɑx
dasxu	dɑsɑx
dadaixu	dɑdɪːx
dadaganaxu	dɑdɡɑnɑx
dadagardaxu	dɑdɡɑrdɑx
dadulgaǰixu	dɑdlɑɡʤɪx
dadxalsixu	dɑdɡɑlʃɪx~dɑdɡɑːlʃɪx
dadxu	dɑdɑx
dačalaxu	dɑːʧlɑx
daǰindaxu	dɑʤɪndɑx
daǰirxaxu	dɑʤɪrxɑx
daraixu	dɑrɪːx
daragalaxu	dɑrɑːlɑx
daragalagulxu	dɑrɑːlʊːlɑx
darixu	dærɪx
darigulxu	dærɪʊlɑx
daruibčilaxu	dɑrɪːbʧlɑx
daruudaxu	dɑrʊːdɑx
daruŋguilaxu	dɑrɑŋɡʊɪlɑx
daruŋguidxu	dɑrɑŋɡʊɪtɑx
daruxu	dɑrɑx
darugalaxu	dɑrɡɑlɑx
darugulxu	dɑrʊːlɑx
daruguldaxu	dɑrʊːldɑx
darugdaxu	dɑrɑɡdɑx
darugdagulxu	dɑrɑɡdʊːlɑx
darumallaxu	dɑrmɑllɑx
darumtalaxu	dɑrɑmtlɑx
darulaxu	dɑrlɑx
darulxilaxu	dɑrɑlxiːləx
darusixu	dɑrʃɪx
darusigulxu	dɑrʃʊːlɑx
darusilaxu	dɑrʃlɑx
darbaixu	dɑrbɪːx
darbaganaxu	dɑrɑbɡɑnɑx
darbalǰaxu	dɑrbɑlʤɪx
darbixu	dærbɑx
darbiginaxu	dærbɑɡnɑx
darxalaxu	dɑrxlɑx
darxiixu	dærxɪːx
dargixu	dærɡɪːx
dargilxu	dærɡɪlɑx
dargiraxu	dærɡɪrɑx
darsaixu	dɑrsɪːx
darsagardaxu	dɑrsɡɑrdɑx
dardaixu	dɑrdɪːx
dardaganaxu	dɑrdɡɑnɑx
darčiginaxu	dɑrʧɪɡnɑx
darǰiginaxu	dɑrʤɪɡnɑx
deilügdexü	diːləɡdəx
deilxü	diːləx
deildexü	diːldəx
deüligečexü	duːləɡʧix
deülilexü	duːlləx
deülgerdexü	duːlɡərdəx
dendeixü	dəndiːx
dendegenexü	dəndəɡnəx
dendelǰexü	dəndəlʤix
denǰiixü	dənʤiːx
denǰigenexü	dənʤiɡnəx
denǰilǰexü	dənʤilʤix
deŋneixü	dəɡniːx
deŋnexü	dəɡnəx
deŋnelǰexü	dəɡnəlʤix
deŋxeixü	dəŋxiːx
deŋxegenexü	dəŋxəɡnəx
deŋxelǰexü	dəŋxəlʤix
deŋselexü	dəŋsləx
deŋselxü	dəŋsləx
deŋselgexü	dəŋsləɡəx
deŋsixü	dəŋʃix
deŋdexü	dəŋdəx
deŋdegülxü	dəŋduːləx
debegerexü	dəbəːrəx
deberexü	dəbrəx
debixü	dəbəx
debigenexü	dəbəɡnəx
debigürdexü	dəbuːrdəx
debilxilexü	dəbəlxiːləx
debilǰexü	dəbəlʤix
debisxerlexü	dəbsɡərləx
debisxü	dəbsəx
debülxü	dəbləx
debürelexü	dəbərləx
debxexü	dəbxəx
debxelxü	dəbxləx
debxečexü	dəbxʧix
debxerxü	dəbxrəx
debsexü	dəbsəx
debselexü	dəbsələx
debselxilexü	dəbsəlxiːləx
debsečixü	dəbsʧix
debsixü	dəbʃix
debsigülxü	dəbʃuːləx
debterlexü	dəbtərləx
debtüxü	dəbtəx
debtügexü	dəbtəːx
debderixü	dəbdrəx
debǰixü	dəbʤix
debǰiyerexü	dəbʤəːrəx
dexigürdexü	dəxuːrdəx
degleixü	dəɡliːx
degligdexü	dəɡləɡdəx
degterlexü	dəɡtərləx
degdeixü	dəɡdiːx
degdexü	dəɡdəx
degdegenexü	dəɡdəɡnəx
degdegexü	dəɡdəːx
degdegülxü	dəɡduːləx
degdelǰexü	dəɡdəlʤix
degdülxü	dəɡdləx
degǰixü	dəɡʤix
degǰirexü	dəɡʤrəx
degǰirxexü	dəɡʤirxəx
degeixü	dəɡiːx
degenčexü	dəɡənʧix
degebexü	dəːbəx
degebürlexü	dəːbərləx
degegsilexü	dəːʃləx
degegsilegülxü	dəːʃluːləx
degegsidexü	dəːʃdəx
degegelexü	dəːɡəːləx
degegedexü	dəːɡəːdəx
degegürdexü	dəːɡuːrdəx
degesülexü	dəːsləx
degeslexü	dəɡsləx
degesdexü	dəɡsdəx
degedülexü	dəːdləx
degedüčilexü	dəːdʧiləx
degečexü	dəɡʧix
degeǰilexü	dəːʤləx
degereŋgüilexü	dəːrəŋɡuiləx
degereŋgüidexü	dəːrəŋɡuidəx
degeremlexü	dəːrəmləx
degeremdexü	dəːrəmdəx
degerelxexü	dəːrəlxəx
degeredexü	dəːrdəx
degeredxexü	dəːrtɡəx
degeredxü	dəːrtəx
degülexü	duːləx
degülixü	duːləx
degüčilexü	duːʧləx
degüčilemdexü	duːʧləmdəx
degüǰiŋnexü	duːʤiɡnəx
degüǰiŋdexü	duːʤiŋdəx
degüǰilexü	duːʤləx
degürxü	duːrəx
demeirexü	dəmiːrəx
demnexü	dəmnəx
dembelǰexü	dəmbəlʤix
demčilexü	dəmʧləx
demǰixü	dəmʤix
deleürexü	dəluːrəx
deleŋnexü	dələɡnəx
deleŋdexü	dələŋdəx
delebčilexü	dələbʧləx
delexü	dələx
delesxü	dəlsəx
deledxü	dəldəx
delixü	dələx
deligütüxü	dəluːtəx
deligürexü	dəluːrəx
delimlexü	dələmləx
delbeixü	dəlbiːx
delbexü	dəlbəx
delbegenexü	dəlbəɡnəx
delbegelexü	dəlbəːləx
delbegerdexü	dələbɡərdəx
delbelxü	dələbləx
delbelǰexü	dəlbəlʤix
delbečixü	dələbʧix
delberexü	dələbrəx
delgexü	dəlɡəx
delgerexü	dəlɡərəx
delgeregülxü	dəlɡəruːləx
dellexü	dəlləx
deldeixü	dəldiːx
deldexü	dəldəx
deldegenexü	dəldəɡnəx
deldelǰexü	dəldəlʤix
deslexü	dəsləx
ded'lexü	dədləx
dedeixü	dədiːx
dedegenexü	dədəɡnəx
dedegerdexü	dədɡərdəx
dedelǰexü	dədəlʤix
dereixü	dəriːx
deregerdexü	dərɡərdəx
derelexü	dərləx
derelǰexü	dərəlʤix
deresülexü	dərsləx
derbeixü	dərbiːx
derbexü	dərbəx
derbegenexü	dərbəɡnəx
derbelxilexü	dərbəlxiːləx
derbelǰexü	dərbəlʤix
derdeixü	dərdiːx
derdegenexü	dərdəɡnəx
derdelǰexü	dərdəlʤix
derčiixü	dərʧiːx
derčiginexü	dərʧiɡnəx
derčigirdexü	dərʧɡərdəx
derčilǰexü	dərʧilʤix
diŋginaxu	dɪŋɡɪnɑx
diglexü	diɡləx
diglerexü	diɡlərəx
d'iselexü	diːsləx~diːʣləx
doogurdaxu	dɔːɡʊːrdɑx
doorasiyaxu	dɔːrʃɔːx
dooradaxu	dɔːrdɔx
doŋnigudaxu	dɔɡnɪʊdɑx
doŋnoixu	dɔɡnɔɪx
doŋnogonaxu	dɔɡnɔɡɔnɔx
doŋnolǰaxu	dɔɡnɔlʤɪx
doŋxoixu	dɔŋxɔɪx
doŋxogonaxu	dɔŋxɡɔnɔx
doŋxolǰaxu	dɔŋxɔlʤɪx
doŋgiyatuxu	dœŋɡɪɔtɔx
doŋgiyadaxu	dœŋɡɪɔdɔx
doŋgiyaraxu	dœŋɡɪɔrɔx
doŋgosxu	dɔŋɡɔsɔx
doŋgodxu	dɔŋɡɔdɔx
doŋsixu	dɔŋʃɪx
doŋsolxu	dɔŋslɔx
doŋsolgaxu	dɔŋsɔlɡɔx
doboixu	dɔbɔɪx
dobogonaxu	dɔbɡɔnɔx
dobtolxu	dɔbtlɔx
dobtolgaxu	dɔbtɔlɡɔx
dobǰiyalaxu	dɔbʤɔːlɔx
doxiixu	dœxɪːx
doxixu	dœxɪx
doxiganaxu	dœxɡɔnɔx
doxigardaxu	dœxɡɔrdɔx
doxigurdaxu	dœxɪʊrdɑx
doxilǰaxu	dœxɪlʤɪx
doxiyalaxu	dœxɪɔlɔx
doxodaxu	dɔxdɔx
dogidaxu	dœɡdɔx
dogiraxu	dœɡrɔx
dogirxaxu	dœɡɪrxɔx
dogirsixu	dœɡɪrʃɪx
dogončaxu	dɔɡɔnʧɪx
dogogilaxu	dœːɡlɔx
dogogsilaxu	dɔːʃlɔx
dogogsilagulxu	dɔːʃlʊːlɑx
dogogsidaxu	dɔːʃdɔx
dogogsiraxu	dɔːʃrɔx
dogolaŋtuxu	dɔɡlɔŋtɔx
dogolxu	dɔɡlɔx
dogolgaxu	dɔɡɔlɡɔx
dogoldaxu	dɔɡɔldɔx
dogolčaxu	dɔɡɔlʧɪx
dogočaxu	dɔɡʧɪx
dogsiraxu	dɔɡʃrɔx
dogsirxaxu	dɔɡʃɪrxɔx
dogsoixu	dɔɡsɔɪx
dogdogonaxu	dɔɡdɡɔnɔx
dogdogolǰaxu	dɔɡdɡɔlʤɪx
dogdolosxixü	dɔɡdlɔsxiːx
dogdolxu	dɔɡdlɔx
dogdolgaxu	dɔɡdɔlɡɔx
dogdolǰaxu	dɔɡdɔlʤɪx
domoglaxu	dɔmɔɡlɔx
domnoxu	dɔmnɔx
domboixu	dɔmbɔɪx
domlaxu	dɔmlɔx
doliixu	dœlɪːx
doliudaxu	dœlɪʊdɑx
doliŋgarlaxu	dœlɪŋɡɔrlɔx
doliŋgarsixu	dœlɪŋɡɔrʃɪx
doliŋgardaxu	dœlɪŋɡɔrdɔx
doliganaxu	dœlɡɔnɔx
dolilǰaxu	dœlɪlʤɪx
doliyaxu	dɔlɔːx
dolirdaxu	dœlɪrdɔx
dolobortoxu	dɔlɔːbɔrtɔx
dologobortoxu	dɔlɔːbɔrtɔx
dologoxu	dɔlɔːx
dologolgaxu	dɔlɔːlɡɔx
dololgaxu	dɔlɔːlɡɔx
doloraxu	dɔlrɔx
dolgixu	dœlɡɪx
dolgilaxu	dœlɡɪlɔx
dolgisxu	dœlɡɪsɔx
dolgidaxu	dœlɡɪdɔx
dolgiyalaxu	dœlɡɪɔlɔx
dolgirxaxu	dœlɡɪrxɔx
dolgončoglaxu	dɔlɡɔnʧɪɡlɔx
dolsilaxu	dɔlʃlɔx
doldoilaxu	dɔldœːlɔx
doldoidxu	dɔldœːdɔx
doldogonaxu	dɔldɡɔnɔx
dolǰiixu	dœlʤɪːx
dotonolaxu	dɔtɔnlɔx
dotonočilaxu	dɔtɔnʧlɔx
dotonočirxaxu	dɔtɔnʧɪrxɔx
dotogurdaxu	dɔtʊːrdɑx
dotogurčilaxu	dɔtʊːrʧlɑx
dotogsilaxu	dɔtɔɡʃlɔx
dotogsidaxu	dɔtɔɡʃdɔx
dotolaxu	dɔtlɔx
dotoračilaxu	dɔtɔrʧlɔx
dotorlaxu	dɔtɔrlɔx
dodomdaxu	dɔtɔmdɔx
doyiixu	dɔjɪːx
doyixu	dɔjɪːx
doyiganaxu	dɔjɡɔnɔx
doyilǰaxu	dɔjɪlʤɪx
doroitaxu	dɔrœːtɔx
doroitagulxu	dɔrœːtʊːlɑx
dorogsilaxu	dɔrɔɡʃlɔx
dorogsilagulxu	dɔrɔɡʃlʊːlɑx
dorogsidaxu	dɔrɔɡʃdɔx
doromǰilaxu	dɔrɔmʤlɔx
dorosiyaxu	dɔrʃɔːx
dorodaxu	dɔrdɔx
dorodxaxu	dɔrtɡɔx
dorodxu	dɔrdɔx
dorbiǰixu	dœrɪbʤɪx
dorboixu	dɔrbɔɪx
dorbogonaxu	dɔrɔbɡɔnɔx
dorbolǰaxu	dɔrbɔlʤɪx
dorgixu	dœrɡɪx
dorgigulxu	dœrɡɪʊlɑx
dorgilaxu	dœrɡɪlɔx
dorgilgaxu	dœrɡɪlɡɔx
dorgiyaxu	dœrɡɪɔx
dorgomdaxu	dɔrɡɔmdɔx
dorgomǰidaxu	dɔrɡɔmʤdɔx
dorsoixu	dɔrsɔɪx
dorsogoidaxu	dɔrsɡœːdɔx
dorsogonaxu	dɔrsɡɔnɔx
dorsogordaxu	dɔrsɡɔrdɔx
dorsogčaxu	dɔrsɔɡʧɪx
dorsolǰaxu	dɔrsɔlʤɪx
dordoixu	dɔrdɔɪx
dordogonaxu	dɔrdɡɔnɔx
dordolǰaxu	dɔrdɔlʤɪx
duugarxu	dʊɡrɑx
duugargaxu	dʊɡɑrɡɑx
duniixu	dʊnɪːx
dunixu	dʊnɪx
dunilǰaxu	dʊnɪlʤɪx
duniyaraxu	dʊnɪɑrɑx
dundaraxu	dʊndrɑx
dunduguilaxu	dʊndɡʊɪlɑx
duŋxaixu	dʊŋxɪːx
duŋxuixu	dʊŋxɪːx
duŋxulǰaxu	dʊŋxɑlʤɪx
duŋguildaxu	dʊŋɡʊɪldɑx
duŋsixu	dʊŋʃɪx
duxuixu	dʊxɪːx
duxuxu	dʊxɑx
duxuganaxu	dʊxɡɑnɑx
duxulǰaxu	dʊxɑlʤɪx
duxudaxu	dʊxdɑx
duguilaxu	dʊɡʊɪlɑx
duguildaxu	dʊɡʊɪldɑx
duguilčaxu	dʊɡʊɪlʧɪx
duguičaxu	dʊɡʊɪʧɪx
duguiraxu	dʊɡʊɪrɑx
dugunixu	dʊːnɪx
dugulagalaxu	dʊːlɡɑlɑx
dugulxu	dʊːlɑx
dugulgaxu	dʊːlɡɑx
duguldaxu	dʊːldɑx
duguraxu	dʊːrɑx
duguraxu	dʊɡrɑx
duguriglaxu	dʊɡrɑɡlɑx
dugxixu	dʊɡxiːx
dugtuilaxu	dʊɡtɪːlɑx
dugtučixu	dʊɡtʧɪx
dugturxilaxu	dʊɡtɑrxiːləx
dugturxu	dʊɡtrɑx
dugǰiguraxu	dʊɡʤʊːrɑx
dugǰiraxu	dʊɡʤrɑx
dumbaixu	dʊmbɪːx
dumdagurlaxu	dʊndʊːrlɑx
dumdagurdaxu	dʊndʊːrdɑx
dumdalaxu	dʊndlɑx
dumdačilaxu	dʊndɑʧlɑx
dumdaraxu	dʊndrɑx
dulaixu	dʊlæːx
dulabalǰaxu	dʊlbɑlʤɪx
dulaxu	dʊlɑx
dulagalaxu	dʊlɑːlɑx
dulagačaxu	dʊlɑːʧɪx
dulagaraxu	dʊlɑːrɑx
dulalǰaxu	dʊlɑlʤɪx
dulasxixü	dʊlsxiːx
dularaxu	dʊlrɑx
dulixu	dʊlɪx
dulidaxu	dʊlʲdɑx
duliyaraxu	dʊlɪɑrɑx
dulduidxu	dʊldɪːdɑx
dusuŋnaxu	dʊsɑɡnɑx
dusuxu	dʊsɑx
dusuganaxu	dʊsɡɑnɑx
dusugaxu	dʊsɑːx
dusulaxu	dʊslɑx
dutaxu	dʊtɑx
dutagaxu	dʊtɑːx
dutagudaxu	dʊtʊːdɑx
dutagdaxu	dʊtɑɡdɑx
dutamagdaxu	dʊtmɑɡdɑx
dudarailaxu	dʊdræːlɑx
duraixu	dʊrɪːx
durailgaxu	dʊrɪːlɡɑx
durandaxu	dʊrɑndɑx
durabalǰaxu	dʊrbɑlʤɪx
duralaxu	dʊrlɑx
durasixu	dʊrʃɪx
durasiyaxu	dʊrʃɑːx
durasxaxu	dʊrsɡɑx
durasxu	dʊrsɑx
duradxaxu	dʊrtɡɑx
duradxu	dʊrdɑx
durusulaxu	dʊrslɑx
durbaxu	dʊrbɑx
durbaganaxu	dʊrɑbɡɑnɑx
durbalǰaxu	dʊrbɑlʤɪx
duwalaxu	dʊɑlɑx
döndöixü	dondoix
döndöilexü	dondoilox
döndögenexü	dondoɡnox
döndölǰexü	dondolʤix
döŋgexü	doŋɡox
döŋgelexü	doŋɡolox
dögöxü	doɡox~doxox
dögömčilexü	doɡomʧlox~doxomʧlox
dömönexü	domnox
dömöxü	domox
döliyerexü	doloːrox
dölöxü	dolox
dölögerexü	dolɡoːrox
dölölǰexü	dololʤix
dölörexü	dolrox
dötelexü	dotlox
dötečilexü	dotoʧlox
döǰirexü	doʤrox
döǰirlexü	doʤirlox
dörögebčilexü	doroːbʧlox
dörögelexü	doroːlox
dörölexü	dorlox
dörölǰexü	dorolʤix
dörbelexü	doroblox
dörbelǰilexü	dorbolʤlox
dörbedexü	dorobdox
dörmösölexü	doromslox
dörsöixü	dorsoix
dörsölǰexü	dorsolʤix
düinerexü	duinrəx
düiŋgidexü	duiŋɡədəx
düiŋgirexü	duiŋɡərəx
düiŋgürexü	duiŋɡərəx
düibexü	duibəx
düibegelexü	duibəːləx
düixü	duix
düiǰelexü	duiʣləx
düireŋgidexü	duirəŋɡədəx
düireŋdexü	duirəŋdəx
düirexü	duirəx
düügeürdexü	duːɡuːrdəx
düügexü	duːɡəx
düŋginexü	duŋɡənəx
düŋgürdexü	duŋɡərdəx
düŋsüixü	duŋsiːx
dügürxü	duːrəx
dügürgexü	duːrɡəx
düleitüxü	duliːtəx
düleirexü	duliːrəx
düleirxexü	duliːrxəx
dülerexü	dulrəx
düliixü	duliːx
düliŋgirtüxü	duləŋɡərtəx
dülixü	duləx
düligülxü	duluːləx
dülilexü	dulləx
düdünexü	dudnəx
düdüglexü	dudəɡləx
düdügenexü	dudəɡnəx
düdlexü	dudləx
düǰiginexü	duʤiɡnəx
dürelǰexü	durəlʤix
dürimlexü	durəmləx
dürimdexü	durəmdəx
dürimǰixü	durəmʤix
dürimǰigülxü	durəmʤuːləx
dürilexü	durləx
dürüxü	durəx
dürbexü	durbəx
dürbegexü	durbəːx
dürbelǰexü	durbəlʤix
dürxirexü	durxrəx
dürgixü	durɡəx
dürleixü	durliːx
dürlegenexü	durləɡnəx
dürlelǰexü	durləlʤix
dürsülexü	dursləx
čaibaixu	ʧæːbɪːx
čaibaganaxu	ʧæːbɡɑnɑx
čaibalǰaxu	ʧæːbɑlʤɪx
čaiburtuxu	ʧæːbɑrtɑx
čaiburdaxu	ʧæːbɑrdɑx
čaixu	ʧæːx
čailabalǰaxu	ʧæːlbɑlʤɪx
čailaxu	ʧæːlɑx
čailgaxu	ʧæːlɡɑx
čailǰaxu	ʧæːlʤɪx
čaisaxu	ʧæːsɑx
čairaxu	ʧæːrɑx
čairagulxu	ʧæːrʊːlɑx
čairlaxu	ʧæːrlɑx
čairdaxu	ʧæːrdɑx
čanalaxu	ʧɑnlɑx
čaŋxalaxu	ʧɑŋxlɑx
čaŋxatuxu	ʧɑŋxtɑx
čaŋxirtuxu	ʧæŋxɪrtɑx
čaŋgaxu	ʧɑŋɡɑx
čaŋginaxu	ʧæŋɡɪnɑx
čaŋtuxu	ʧɑŋtɑx
čabausixu	ʧɑbʊːʃɪx
čabaudaxu	ʧɑbʊːdɑx
čabauraxu	ʧɑbʊːrɑx
čabatuxu	ʧɑbtɑx
čabidaixu	ʧæbdɪːx
čabidaxu	ʧæbdɑx
čabuglaxu	ʧɑbɑɡlɑx
čablaxu	ʧɑblɑx
čabdaxu	ʧɑbdɑx
čabčixu	ʧæbʧɪx
čabčiganaxu	ʧæbʧɡɑnɑx
čabčigurdaxu	ʧæbʧʊːrdɑx
čabčilaxu	ʧæbʧlɑx
čaxalaituxu	ʧɑxlæːtɑx
čaxixu	ʧæxɪx
čaxilaxu	ʧæxlɑx
čaxilxu	ʧæxlɑx
čaxilgantuxu	ʧæxɪlɡɑːntɑx
čaxilgančilaxu	ʧæxɪlɡɑːnʧlɑx
čaxilganǰixu	ʧæxɪlɡɑːnʤɪx
čaxilganǰigulxu	ʧæxɪlɡɑːnʤʊːlɑx
čaxulaxu	ʧɑxlɑx
čaxutunaxu	ʧɑxtnɑx
čaxudaxu	ʧɑxdɑx
čaganadaxu	ʧɑːndɑx
čagalaxu	ʧɑɡɑːlɑx
čagalixu	ʧɑɡɑːlɑx
čagasilaxu	ʧɑːʃlɑx
čagasulaxu	ʧɑːslɑx
čagadxaxu	ʧɑɡɑːtɡɑx
čagadxu	ʧɑɡɑːtɑx
čagačilaxu	ʧɑɡɑːʧlɑx
čagaǰalaxu	ʧɑːʤlɑx
čagaraxu	ʧɑɡɑːrɑx
čagariglaxu	ʧɑɡrɪɡlɑx
čagargulaxu	ʧɑːrɡɑlɑx
čagurxaituxu	ʧʊːrxæːtɑx
čagurgalaxu	ʧʊːrɡɑlɑx
čaglaxu	ʧɑɡlɑx
čagdaxu	ʧɑɡdɑx
čamaŋdaxu	ʧɑmɑŋdɑx
čamarxaxu	ʧɑmɑrxɑx
čamnaxu	ʧɑmnɑx
čamxuixu	ʧɑmxɪːx
čalaixu	ʧɑlɪːx
čalaŋtailaxu	ʧɑlɑŋtæːlɑx
čalagairaxu	ʧɑlɡæːrɑx
čalagardaxu	ʧɑlɡɑrdɑx
čalirdaxu	ʧælɪrdɑx
čalgixu	ʧælɡɪx
čalgilaxu	ʧælɡɪlɑx
čalgisxu	ʧælɡɪsɑx
čalgiraxu	ʧælɡɪrɑx
čalmaxu	ʧɑlmɑx
čalmalaxu	ʧɑlɑmlɑx
čalmadaxu	ʧɑlɑmdɑx
čalmurdaxu	ʧɑlmʊːrdɑx
čalčatuxu	ʧɑlʧtɑx
čalčixu	ʧælʧɪx
čalčiyadaxu	ʧælʧɑːdɑx
čalčiyaraxu	ʧælʧɑːrɑx
čalčiraxu	ʧælʧrɑx
čalčiragatuxu	ʧælʧrɑːtɑx
časilaxu	ʧɑːʃlɑx
časilagulxu	ʧɑːʃlʊːlɑx
časidaxu	ʧɑːʃdɑx
časulaxu	ʧɑslɑx
časutuxu	ʧɑstɑx
časuraxu	ʧɑsrɑx
čadugarxaxu	ʧɑdɑːrxɑx
čaduguraxu	ʧɑdʊːrɑx
čadugurxaxu	ʧɑdʊːrxɑx
čadxu	ʧɑdɑx
čadxuixu	ʧɑtɡɪːx
čadxuxu	ʧɑtɡɑx
čadxuldaxu	ʧɑtɡɑldɑx
čačaxu	ʧɑʧɪx
čačagaxu	ʧɑʧɑːx
čačuxu	ʧɑʧɪx
čačuglaxu	ʧɑʧɪɡlɑx
čarildaxu	ʧærɪldɑx
čaruxu	ʧɑrɑx
čarumagailaxu	ʧɑrɑmɡæːlɑx
čarbaxu	ʧɑrbɑx
čarxiraxu	ʧærxrɑx
čarxiralduxu	ʧærxrɑldɑx
čargixu	ʧærɡɪx
čargildaxu	ʧærɡɪldɑx
čargulaxu	ʧɑrɡɑlɑx
čargutuxu	ʧɑrɡɑtɑx
čargudaxu	ʧɑrɡɑdɑx
čarlaxu	ʧɑrlɑx
čartuxu	ʧɑrtɑx
čardaixu	ʧɑrdɪːx
čardaxu	ʧɑrdɑx
čardaguldaxu	ʧɑrdʊːldɑx
čarčaixu	ʧærʧɪːx
čarčaŋgisixu	ʧærʧɪŋɡɪʃɪx
čarčaŋgituxu	ʧærʧɪŋɡɪtɑx
čarčaŋgiraxu	ʧærʧɪŋɡɪrɑx
čarčaxu	ʧærʧɪx
čarčagaxu	ʧærʧɑːx
čenexü	ʧinəx
čeneglexü	ʧinəɡləx
čendeixü	ʧindiːx
čeŋnexü	ʧəɡnəx
čeŋxeixü	ʧiŋxiːx
čeŋxerlexü	ʧiŋxərləx
čeŋxertüxü	ʧiŋxərtəx
čeŋgexü	ʧiŋɡəx
čeŋgeldüxü	ʧiŋɡəldəx
čeŋmelexü	ʧimbələx
čeŋlexü	ʧəŋləx
čeberlexü	ʧibərləx
čebersixü	ʧibərʃix
čeberǰixü	ʧibərʤix
čeberǰigülxü	ʧibərʤuːləx
čebdegsixü	ʧibdəɡʃix
čebdegtüxü	ʧibdəɡtəx
čebdegrexü	ʧibdəɡrəx
čebčeixü	ʧibʧiːx
čegčelexü	ʧiɡʧləx
čegčedxexü	ʧiɡʧitɡəx
čegčedxü	ʧiɡʧtəx
čegčerexü	ʧiɡʧrəx
čegeglexü	ʧəːɡləx~ʧeːɡləx
čegelexü	ʧəːləx
čegelxixü	ʧəːlxiːx
čegeǰilexü	ʧəːʤləx
čegerlexü	ʧəːrləx
čegerlegülxü	ʧəːrluːləx
čegülisdexü	ʧuːlsdəx
čembeixü	ʧimbiːx
čembegenexü	ʧimbəɡnəx
čembelexü	ʧimbələx
čembelǰexü	ʧimbəlʤix
čemčeixü	ʧimʧiːx
čemčegenexü	ʧimʧiɡnəx
čemčelǰexü	ʧimʧilʤix
čeleixü	ʧiliːx
čelelǰexü	ʧiləlʤix
čelgenexü	ʧiləɡnəx
čelgerexü	ʧiləɡrəx
čelmeixü	ʧilmiːx
čelmexü	ʧilməx
čelčeixü	ʧilʧiːx
čelčegenexü	ʧilʧiɡnəx
čelčegerdexü	ʧilʧɡərdəx
čelčelǰexü	ʧilʧilʤix
čedeixü	ʧidiːx
čedegenexü	ʧidəɡnəx
čedelǰexü	ʧidəlʤix
čečeglexü	ʧiʧiɡləx
čečegtüxü	ʧiʧiɡtəx
čečerexü	ʧiʧrəx
čečereglexü	ʧiʧrəɡləx
čečerxexü	ʧiʧirxəx
čečerxilexü	ʧiʧirxiːləx
čečergenexü	ʧiʧrəɡnəx
čečerligǰixü	ʧiʧirləɡʤix
čečerligǰigülxü	ʧiʧirləɡʤuːləx
čeǰeixü	ʧiʤiːx
čeǰegenexü	ʧiʤiɡnəx
čeǰelǰexü	ʧiʤilʤix
čeriglexü	ʧirəɡləx
čerigǰixü	ʧirəɡʤix
čerigǰigülxü	ʧirəɡʤuːləx
čerbexü	ʧirbəx
čerbegdexü	ʧirbəɡdəx
čerbegüdexü	ʧirbuːdəx
čerbelǰexü	ʧirbəlʤix
čermexü	ʧirməx
čerdeixü	ʧirdiːx
čerdexü	ʧirdəx
čerčeixü	ʧirʧiːx
čiixü	ʧiːx
čiiglexü	ʧiːɡləx
čiileixü	ʧiːliːx
čiilexü	ʧiːləx
čiilegenexü	ʧiːləɡnəx
čiilelǰexü	ʧiːləlʤix
čiidegülxü	ʧiːduːləx
čiidemnexü	ʧiːdəmnəx
čiidemlexü	ʧiːdəmləx
činaxu	ʧɑnɑx
činagsilaxu	ʧɑnɑɡʃlɑx
činagsilagulxu	ʧɑnɑɡʃlʊːlɑx
činagsidaxu	ʧɑnɑɡʃdɑx
činarsixu	ʧɪnɑrʃɪx
činarsigulxu	ʧɪnɑrʃʊːlɑx
činarǰixu	ʧɪnɑrʤɪx
činarǰigulxu	ʧɪnɑrʤʊːlɑx
činegeǰixü	ʧinəːʤix
činegerxexü	ʧinəːrxəx
činegerxilexü	ʧinəːrxiːləx
činüxü	ʧinəx
činürexü	ʧinrəx
činǰaldaxu	ʧɪnʤɪldɑx
čiŋnaxu	ʧɪɡnɑx
čiŋxü	ʧinəx
čiŋgagaxu	ʧɑŋɡɑːx
čiŋgagalduxu	ʧɑŋɡɑːldɑx
čiŋgalaxu	ʧɑŋɡɑlɑx
čiŋgasxu	ʧɑŋɡɑsɑx
čiŋgadaxu	ʧɑŋɡɑdɑx
čiŋgadxaxu	ʧɑŋɡɑtɡɑx
čiŋgadxu	ʧɑŋɡɑtɑx
čiŋgaraxu	ʧɑŋɡɑrɑx
čiŋgaragulxu	ʧɑŋɡɑrʊːlɑx
čiŋginaxu	ʧɪŋɡɪnɑx
čiŋgixü	ʧiŋɡəx
čiŋdalaxu	ʧɪŋdlɑx
čiŋdalalčaxu	ʧɪŋdlɑlʧɪx
čiŋdaraxu	ʧɪŋdrɑx
čiŋdaragulxu	ʧɪŋdrʊːlɑx
čibügülxü	ʧibuːləx
čibxaguraxu	ʧɑbxʊːrɑx
čibxagurxaxu	ʧɑbxʊːrxɑx
čibxadaxu	ʧɑbxdɑx
čibxedexü	ʧibxdəx
čibxü	ʧibəx
čibdagurxaxu	ʧɪbdɡɑrxɑx
čibdagsixu	ʧɪbdɑɡʃɪx
čibdagraxaxu	ʧɪbdɡɑrxɑx
čibdagraxu	ʧɪbdɑɡrɑx
čibčirxu	ʧɪbʧrɑx
čibčirgadaxu	ʧɪbʧrɑɡdɑx
čixaraxu	ʧɪxrɑx
čixelexü	ʧixləx
čixixü	ʧixəx
čixigdexü	ʧixəɡdəx
čixilexü	ʧixləx
čixildüxü	ʧixəldəx
čixilčexü	ʧixəlʧix
čixidexü	ʧixdəx
čixičixü	ʧixʧix
čixičildüxü	ʧixʧildəx
čixirxü	ʧixrəx
čixulačilaxu	ʧʊxɑlʧlɑx
čixuldaxu	ʧʊxɑldɑx
čixuldagulxu	ʧʊxɑldʊːlɑx
čiglexü	ʧiɡləx
čiglegülxü	ʧiɡluːləx
čiglerexü	ʧiɡlərəx
čigčilexü	ʧiɡʧləx
čigǰixü	ʧiɡʤix
čigǰigüdexü	ʧiɡʤuːdəx
čigǰigürexü	ʧiɡʤuːrəx
čigǰiyesülexü	ʧiɡʤəːsləx
čigǰirexü	ʧiɡʤrəx
čigiglexü	ʧiːɡləx
čigigsüxü	ʧiːɡsəx
čigigtüxü	ʧiːɡtəx
čigiragsixu	ʧɪːrɑɡʃɪx
čigiragǰixu	ʧɪːrɑɡʤɪx
čigulxu	ʧʊːlɑx
čig°taixu	ʧɪɡtɪːx
čig°tagalaxu	ʧɪɡtɡɑlɑx
čig°talaxu	ʧɪɡtlɑx
čimalaxaxu	ʧɑmɑlxɑx
čimalaxu	ʧɑmlɑx
čimarxaxu	ʧɑmɑrxɑx
čimarlaxu	ʧɑmɑrlɑx
čimexü	ʧiməx
čimeglexü	ʧiməɡləx
čimegelexü	ʧiməːləx
čimögelexü	ʧomoɡlox
čimögečilexü	ʧomoɡʧlox
čimxerilexü	ʧimxəːrləx
čimxixü	ʧimxəx
čimxilexü	ʧimxələx
čimxilxilexü	ʧimxəlxiːləx
čimxiyerilexü	ʧimxəːrləx
čimčiginexü	ʧimʧiɡnəx
čilagutuxu	ʧʊlʊːtɑx
čilagudaxu	ʧʊlʊːdɑx
čilaguǰixu	ʧʊlʊːʤɪx
čilaguraxu	ʧʊlʊːrɑx
čilexü	ʧiləx
čilegexü	ʧiləːx
čilegerxexü	ʧiləːrxəx
čiliixü	ʧiliːx
čilögelexü	ʧoloːlox
čilögelegdexü	ʧoloːloɡdox
čilögečilexü	ʧoloːʧlox
čilögeǰixü	ʧoloːʤix
čilögeǰigülxü	ʧoloːʤuːləx
čilbaixu	ʧɪlbɪːx
čilgexü	ʧilɡəx
čilgersixü	ʧilɡərʃix
čildeixü	ʧildiːx
čildeŋsixü	ʧildəŋʃix
čiselexü	ʧiːsləx
čisulaxu	ʧʊslɑx
čisudaxu	ʧʊsdɑx
čisurxaxu	ʧʊsɑrxɑx
čidaburilaxu	ʧɪdbɑrlɑx
čidaburisixu	ʧɪdbɑrʃɪx
čidaburiǰixu	ʧɪdbɑrʤɪx
čidaxu	ʧɪdɑx
čidamagaidaxu	ʧɪdɑmɡæːdɑx
čidamagairaxu	ʧɪdɑmɡæːrɑx
čidamagairxaxu	ʧɪdɑmɡæːrxɑx
čidamagdaxu	ʧɪdmɑɡdɑx
čidörlexü	ʧodorlox
čidörlegdexü	ʧodorloɡdox
čidxaixu	ʧɪdxɪːx
čidxuxu	ʧʊtɡɑx
čidxulaxu	ʧʊtɡɑlɑx
čičaulaxu	ʧɪʧʊːlɑx
čičabaganaxu	ʧɪʧɪbɡɑnɑx
čičabalǰaxu	ʧɪʧbɑlʤɪx
čičagadaxu	ʧɪʧɡɑdɑx
čičagaraxu	ʧɪʧɡɑrɑx
čičarxailaxu	ʧɪʧɪrxæːlɑx
čičixü	ʧiʧix
čičigenexü	ʧiʧiɡnəx
čičigexü	ʧiʧəːx
čičilexü	ʧiʧləx
čiraixu	ʧɪrɪːx
čirailaxu	ʧæræːlɑx
čiraidaxu	ʧæræːdɑx
čiraičilaxu	ʧæræːʧlɑx
čiralaxu	ʧɪrlɑx
čirügdexü	ʧirəɡdəx
čirügdegülxü	ʧirəɡduːləx
čirügülxü	ʧiruːləx
čirüldüxü	ʧirəldəx
čirbexü	ʧirbəx
čirxiraxu	ʧɪrxrɑx
čirxü	ʧirəx
čirgagusxu	ʧɪrɡʊːsɑx
čirgagutuxu	ʧɪrɡʊːtɑx
čirgagudaxu	ʧɪrɡʊːdɑx
čirgagdaxu	ʧɪrɡɑɡdɑx
čirgalaxu	ʧɪrɡɑlɑx
čirgeüldexü	ʧirɡuːldəx
čirmaixu	ʧærmæːx
čirmaxu	ʧɪrmɑx
čirdaixu	ʧɪrdɪːx
čirdaganaxu	ʧɪrdɡɑnɑx
čirdalǰaxu	ʧɪrdɑlʤɪx
čoilaxu	ʧœːlɔx
čoičoixu	ʧœːʧɪːx
čooǰilaxu	ʧɔːʤlɔx
čonoxu	ʧɔnɔx
čonogaxu	ʧɔnɔːx
čonoglaxu	ʧɔːnɔɡlɔx~ʧɔnɔɡlɔx
čondoixu	ʧɔndɔɪx
čondoglaxu	ʧɔndɔɡlɔx
čoŋnoixu	ʧɔɡnɔɪx
čoŋxiixu	ʧœŋxɪːx
čoŋxirtoxu	ʧœŋxɪrtɔx
čobogoraxu	ʧɔbɔːrɔx
čobxočixu	ʧɔbxʧɪx
čobxoraxu	ʧɔbxrɔx
čobdolaxu	ʧɔbdlɔx
čoxixu	ʧœxɪx
čoxilaxu	ʧœxlɔx
čoxilduxu	ʧœxɪldɔx
čoxoitoxu	ʧɔxœːtɔx
čoxoidaxu	ʧɔxœːdɔx
čoxoiǰixu	ʧɔxœːʤɪx
čoxoxu	ʧɔxɔx
čoxolaxu	ʧɔxlɔx
čoxolxu	ʧɔxlɔx
čoxodaxu	ʧɔxdɔx
čoxoroxu	ʧɔxrɔx
čoxorolduxu	ʧɔxrɔldɔx
čoxorlaxu	ʧɔːxɔrlɔx
čoxortoxu	ʧɔːxɔrtɔx
čoxordaxu	ʧɔːxɔrdɔx
čogogčilaxu	ʧɔːɡʧlɔx
čogolidxu	ʧɔːldɔx
čogolborilaxu	ʧɔːlbɔrlɔx
čogolxu	ʧɔːlɔx
čogočixu	ʧɔːʧɪx
čogoroxu	ʧɔːrɔx
čoggixu	ʧœɡɪx
čogsixu	ʧɔɡʃɪx
čogčalaxu	ʧɔɡʧlɔx
čogčoixu	ʧɔɡʧɪːx
čogčogordaxu	ʧɔɡʧɡɔrdɔx
čomoixu	ʧɔmɔɪx
čomoxu	ʧɔmɔx
čomoglaxu	ʧɔmɔɡlɔx
čomorliglaxu	ʧɔmɔrlɔɡlɔx
čomorligtoxu	ʧɔmɔrlɔɡtɔx
čomboixu	ʧɔmbɔɪx
čombogordaxu	ʧɔmbɔɡɔrdɔx
čomxadxaxu	ʧɔmxɔtɡɔx
čomxadxu	ʧɔmxɔtɔx
čomxaraxu	ʧɔmxɔrɔx
čomčoixu	ʧɔmʧɪːx
čomčogonaxu	ʧɔmʧɡɔnɔx
čomčogordaxu	ʧɔmʧɡɔrdɔx
čomčolǰaxu	ʧɔmʧɪlʤɪx
čomčorixu	ʧɔmʧrɔx
čolalaxu	ʧɔllɔx
čolgixu	ʧœlɡɪx
čolgilaxu	ʧœlɡɪlɔx
čolgoraxu	ʧɔlɡɔrɔx
čolčogonaxu	ʧɔlʧɡɔnɔx
čodoixu	ʧɔdɔɪx
čodogonaxu	ʧɔdɡɔnɔx
čodolǰaxu	ʧɔdɔlʤɪx
čodlaxu	ʧɔdlɔx
čočixu	ʧœʧɪx
čočigaxu	ʧœʧɔːx
čočimagdaxu	ʧœʧmɔɡdɔx
čočirdaxu	ʧœʧɪrdɔx
čočoxu	ʧɔʧɪx
čoǰoixu	ʧɔʤɪːx
čoǰogonaxu	ʧɔʤɡɔnɔx
čoǰolǰaxu	ʧɔʤɪlʤɪx
čoroixu	ʧɔrɔɪx
čoroilaxu	ʧɔrɔɪlɔx
čoroilgaxu	ʧɔrɔɪlɡɔx
čorboixu	ʧɔrbɔɪx
čorbogonaxu	ʧɔrɔbɡɔnɔx
čorbogordaxu	ʧɔrɔbɡɔrdɔx
čorbolǰaxu	ʧɔrbɔlʤɪx
čorbodaxu	ʧɔrɔbdɔx
čorgixu	ʧœrɡɪx
čorgilaxu	ʧœrɡɪlɔx
čorgolaxu	ʧɔrɡɔlɔx
čorgodaxu	ʧɔrɡɔdɔx
čuuxaltuxu	ʧʊːxɑltɑx
čuuxaldaxu	ʧʊːxɑldɑx
čuuginaxu	ʧʊːɡnɑx
čuugixu	ʧʊːɡɪx
čuugigulxu	ʧʊːɡɪʊlɑx
čuugilduxu	ʧʊːɡɪldɑx
čuulisdaxu	ʧʊːlɪsdɑx
čuudamnaxu	ʧʊːdɑmnɑx
čuudamlaxu	ʧʊːdɑmlɑx
čuuraituxu	ʧʊːræːtɑx
čuuriyatuxu	ʧʊːrɪɑtɑx
čuuriyadaxu	ʧʊːrɪɑdɑx
čuurxaxu	ʧʊːrxɑx
čunčaixu	ʧʊnʧɪːx
čunčaganaxu	ʧʊnʧɡɑnɑx
čunčalǰaxu	ʧʊnʧɪlʤɪx
čubuxu	ʧʊbɑx
čubugaraxu	ʧʊbɑːrɑx
čubugaralduxu	ʧʊbɑːrɑldɑx
čubugulxu	ʧʊbʊːlɑx
čubulduxu	ʧʊbɑldɑx
čuburaxu	ʧʊbrɑx
čuburagaxu	ʧʊbrɑːx
čuburagulxu	ʧʊbrʊːlɑx
čuburixu	ʧʊbrɑx
čuxagdaxu	ʧʊxɑɡdɑx
čuxuixu	ʧʊxɪːx
čuxuilaxu	ʧʊxɪːlɑx
čuxumlaxu	ʧʊxɑmlɑx~ʧɔxɔmlɔx
čuxulǰaxu	ʧʊxɑlʤɪx
čuxurixu	ʧʊxrɑx
čugulxu	ʧʊːlɑx
čugučixu	ʧʊːʧɪx
čuguraxu	ʧʊːrɑx
čugurdaxu	ʧʊːrdɑx~ʧɔːrdɔx
čuglaxu	ʧʊɡlɑx
čuglagaxu	ʧʊɡlɑːx
čuglagulxu	ʧʊɡlʊːlɑx
čuglaraxu	ʧʊɡlɑrɑx
čuglaragulxu	ʧʊɡlɑrʊːlɑx
čulbugurdaxu	ʧʊlbʊːrdɑx
čulxuixu	ʧʊlxɪːx
čulxuganaxu	ʧʊlxɡɑnɑx
čulxulǰaxu	ʧʊlxɑlʤɪx
čulguilaxu	ʧʊlɡʊɪlɑx
čulguidaxu	ʧʊlɡʊɪdɑx
čulguiraxu	ʧʊlɡʊɪrɑx
čulčaixu	ʧʊlʧɪːx
čulčaganaxu	ʧʊlʧɡɑnɑx
čulčalǰaxu	ʧʊlʧɪlʤɪx
čulčarixu	ʧʊlʧrɑx
čulčariyatuxu	ʧʊlʧrɑːtɑx
čulčiginaxu	ʧʊlʧɪɡnɑx
čulčuŋtuxu	ʧʊlʧɪŋtɑx
čučaxu	ʧʊʧɪx
čučalaxu	ʧʊʧlɑx
čučalxu	ʧʊʧlɑx
čučaraxu	ʧʊʧrɑx
čuraxu	ʧʊːrɑx
čurbadaxu	ʧʊrɑbdɑx
čurxiraxu	ʧʊrxʲrɑx
čurxiralduxu	ʧʊrxʲrɑldɑx
čurxiralčaxu	ʧʊrxʲrɑlʧɪx
čurmadaxu	ʧʊrɑmdɑx
čöbörigütüxü	ʧobruːtəx
čöbtöxü	ʧobtox
čöxöxü	ʧoxox
čöxögsixü	ʧoxoɡʃix
čöxörexü	ʧoxrox
čöglexü	ʧoɡlox
čögčöixü	ʧoɡʧiːx
čögčögenexü	ʧoɡʧiɡnox
čögčölǰexü	ʧoɡʧilʤix
čögebčilexü	ʧoːbʧlox
čögexečilexü	ʧoːxʧlox
čögexerexü	ʧoːxrox
čögelexü	ʧoːlox
čögedexü	ʧoːdox
čögedxexü	ʧoːtɡox
čögedxü	ʧoːtox
čögečilexü	ʧoːʧlox
čögerexü	ʧoːrox
čögeregülxü	ʧoːruːləx
čögöčelexü	ʧoɡʧlox
čömesixü	ʧomʃix
čömetüxü	ʧomtox
čömöxü	ʧomox
čömölxü	ʧomlox
čömöčixü	ʧomʧix
čömörexü	ʧomrox
čömčixü	ʧomʧix
čömčöixü	ʧomʧiːx
čömčörixü	ʧomʧrox
čölexü	ʧolox
čöliixü	ʧoliːx
čölbexü	ʧolbox
čölmöxü	ʧolmox
čöčiixü	ʧoʧiːx
čöčigenexü	ʧoʧiɡnox
čöröixü	ʧoroix
čörböixü	ʧorboix
čörbögenexü	ʧorboɡnox
čörbölǰexü	ʧorbolʤix
čörxelexü	ʧorxlox
čörčiixü	ʧorʧiːx
čüüčeixü	ʧuːʧiːx
čüüčegenexü	ʧuʧiɡnəx
čüüčelǰexü	ʧuːʧilʤix
čüüreixü	ʧuːriːx
čüüregenexü	ʧuːrəɡnəx
čüürelǰexü	ʧuːrəlʤix
čündüixü	ʧundiːx
čüŋxüixü	ʧuŋxiːx
čügdüixü	ʧuɡdiːx
čügčürgelexü	ʧuɡʧrəɡləx~ʧuɡʧuːrəɡləx
čülexü	ʧuːləx
čülixü	ʧuːləx
čülisdexü	ʧulsdəx
čülüŋnexü	ʧuləɡnəx
čülxüixü	ʧulxiːx
čülxügenexü	ʧulxəɡnəx
čülxülǰexü	ʧulxəlʤix
čüdexü	ʧuːdəx
čüčeixü	ʧuːʧiːx
čüčedexü	ʧuːʧdəx
čüǰeixü	ʧuʤiːx
čüǰegenexü	ʧuʤiɡnəx
čüreixü	ʧuriːx
čürdeixü	ʧurdiːx
čürdegenexü	ʧurdəɡnəx
čürdelǰexü	ʧurdəlʤix
ǰaibaixu	ʤæːbɪːx
ǰaibaganaxu	ʤæːbɡɑnɑx
ǰaibalǰaxu	ʤæːbɑlʤɪx
ǰaixu	ʤæːx
ǰaimuxu	ʤæːmɑx
ǰaimuraxu	ʤæːmrɑx
ǰailaxu	ʤæːlɑx
ǰailagulxu	ʤæːlʊːlɑx
ǰailasxixü	ʤæːlsxiːx
ǰailxu	ʤæːlɑx
ǰaisxixü	ʤæːsxiːx
ǰaidaŋnaxu	ʤæːdɑɡnɑx
ǰaidaŋdaxu	ʤæːdɑŋdɑx
ǰaidaxu	ʤæːdɑx
ǰaidalaxu	ʤæːdlɑx
ǰaidasulaxu	ʤæːdɑslɑx
ǰaidxu	ʤæːdɑx
ǰaičaxu	ʤæːʧɪx
ǰairaŋnaxu	ʤæːrɑɡnɑx
ǰairmaglaxu	ʤæːrmɑɡlɑx
ǰairtuxu	ʤæːrtɑx
ǰanuxu	ʤɑnɑx
ǰantaixu	ʤɑntɪːx
ǰantaganaxu	ʤɑntɡɑnɑx
ǰantalǰaxu	ʤɑntɑlʤɪx
ǰandamdaxu	ʤɑndɑmdɑx
ǰančixu	ʤænʧɪx
ǰančilduxu	ʤænʧɪldɑx
ǰaŋnaxu	ʤɑɡnɑx~ʤæɡnɑx
ǰaŋxaixu	ʤɑŋxæːx
ǰaŋxaganaxu	ʤɑŋxɡɑnɑx
ǰaŋxalǰaxu	ʤɑŋxɑlʤɪx
ǰaŋgaixu	ʤɑŋɡæːx
ǰaŋgaxu	ʤɑŋɡɑx
ǰaŋgilaxu	ʤæŋɡɪlɑx
ǰaŋgidxu	ʤæŋɡɪdɑx
ǰaŋgiyalaxu	ʤæŋɡɪɑlɑx
ǰaŋgiyasulaxu	ʤæŋɡɪɑslɑx
ǰaŋgiraxu	ʤæŋɡɪrɑx
ǰaŋgiragatuxu	ʤæŋɡɪrɑːtɑx
ǰaŋguraxu	ʤɑŋɡɑrɑx
ǰaŋgurgalaxu	ʤɑŋɡʊːrɑɡlɑx
ǰaŋgurgadaxu	ʤɑŋɡʊːrɑɡdɑx
ǰaŋguwasalaxu	ʤɑŋɡʊɑslɑx
ǰaŋsixu	ʤɑŋʃɪx
ǰaŋsilaxu	ʤɑŋʃlɑx
ǰaŋdaxu	ʤɑŋdɑx
ǰaŋdurxilaxu	ʤɑŋdɑrxiːləx
ǰaŋdurxu	ʤɑŋdrɑx
ǰaŋǰulaxu	ʤæŋʤlɑx
ǰabagadaxu	ʤɑbɑːdɑx
ǰabagaraxu	ʤɑbɑːrɑx
ǰabilaxu	ʤæblɑx
ǰabxaidaxu	ʤɑbxæːdɑx
ǰabxairaxu	ʤɑbxæːrɑx
ǰabxaxu	ʤɑbxɑx
ǰabxaraxu	ʤɑbxrɑx
ǰabsarlaxu	ʤɑbsɑrlɑx
ǰabsartuxu	ʤɑbsɑrtɑx
ǰabsardaxu	ʤɑbsɑrdɑx
ǰabsardagulxu	ʤɑbsɑrdʊːlɑx
ǰabsarčilaxu	ʤɑbsɑrʧlɑx
ǰabsixu	ʤɑbʃɪx~ʤæbʃɪx
ǰabsiyančilaxu	ʤɑbʃɑːnʧlɑx~ʤæbʃɑːnʧlɑx
ǰabduxu	ʤɑbdɑx
ǰabčilaxu	ʤɑbʧlɑx
ǰaxalaxu	ʤɑxlɑx
ǰaxixu	ʤæxɪx
ǰaxiyalaxu	ʤæxɪɑlɑx
ǰaxirxu	ʤæxrɑx
ǰagaxu	ʤɑːx
ǰagaglaxu	ʤɑːɡlɑx
ǰagamadaxu	ʤɑːmdɑx
ǰagalaxu	ʤɑɡɑːlɑx
ǰagalxu	ʤɑɡlɑx
ǰagalmailaxu	ʤɑɡɑlmæːlɑx
ǰagalmaidaxu	ʤɑɡɑlmæːdɑx
ǰagalduxu	ʤɑːldɑx
ǰagatunaxu	ʤɑɡtnɑx
ǰagadaxu	ʤɑɡɑːdɑx
ǰagadasulaxu	ʤɑːdɑslɑx
ǰagaduudaxu	ʤɑːdʊːdɑx
ǰagaǰalaxu	ʤɑːʣlɑx
ǰagaǰuurdaxu	ʤɑːʤʊːrdɑx
ǰagaraxu	ʤɑːrɑx
ǰagarmaglaxu	ʤɑːrmɑɡlɑx
ǰagarčaglaxu	ʤɑːrʧɪɡlɑx
ǰagisxu	ʤæɡsɑx
ǰaguxu	ʤʊːx
ǰagusilaxu	ʤʊːʃlɑx
ǰagučilaxu	ʤʊːʧlɑx
ǰaguraxu	ʤʊːrɑx
ǰaguralduxu	ʤʊːrɑldɑx
ǰagurmaglaxu	ʤʊːrmɑɡlɑx
ǰagurmalaxu	ʤʊːrɑmlɑx
ǰagburlaxu	ʤɑɡbɑrlɑx
ǰagburčilaxu	ʤɑɡbɑrʧlɑx
ǰagsaxu	ʤɑɡsɑx
ǰagtuxu	ʤɑɡtɑx
ǰagǰaixu	ʤɑɡʤɪːx
ǰamagtuxu	ʤɑmɑɡtɑx
ǰamagraxu	ʤɑmɑɡrɑx
ǰamuglaxu	ʤɑmɑɡlɑx
ǰamurxu	ʤɑmrɑx
ǰamnaxu	ʤɑmnɑx
ǰambiixu	ʤæmbɪːx
ǰambiganaxu	ʤæmbɑɡɑnɑx
ǰambilǰaxu	ʤæmbɑlʤɪx
ǰamxaraxu	ʤɑmxɑrɑx
ǰamsixu	ʤɑmʃɪx
ǰamčilaxu	ʤɑmʧlɑx
ǰalaxaidaxu	ʤɑlxæːdɑx
ǰalaxu	ʤɑlɑx
ǰalagalaxu	ʤɑlɑːlɑx
ǰalagudaxu	ʤɑlʊːdɑx
ǰalaguǰixu	ʤɑlʊːʤɪx
ǰalaguraxu	ʤɑlʊːrɑx
ǰalagurxaxu	ʤɑlʊːrxɑx
ǰalagurdaxu	ʤɑlʊːrdɑx
ǰalaraxu	ʤɑlrɑx
ǰalaragulxu	ʤɑlrʊːlɑx
ǰalixairaxu	ʤɑlxæːrɑx
ǰalilaxu	ʤællɑx
ǰalidaxu	ʤældɑx
ǰaliraxu	ʤælrɑx
ǰalbarixu	ʤælɪbrɑx
ǰalbiixu	ʤælbɪːx
ǰalxaxu	ʤɑlxɑx
ǰalxagaxu	ʤɑlxɑːx
ǰalxagudaxu	ʤɑlxʊːdɑx
ǰalxaguraxu	ʤɑlxʊːrɑx
ǰalgaxu	ʤɑlɡɑx
ǰalgagurlaxu	ʤɑlɡʊːrlɑx
ǰalgamǰilaxu	ʤɑlɡɑmʤlɑx
ǰalgalduxu	ʤɑlɡɑldɑx
ǰalgixu	ʤælɡɪx
ǰalgilaxu	ʤælɡɪlɑx
ǰalgurlaxu	ʤɑlɡʊːrlɑx
ǰasaburilaxu	ʤɑsbɑrlɑx
ǰasaxu	ʤɑsɑx
ǰasaglaxu	ʤɑsɑɡlɑx
ǰasagdaxu	ʤɑsɑɡdɑx
ǰasamǰilaxu	ʤɑsɑmʤlɑx
ǰasadaglaxu	ʤɑsdɑɡlɑx
ǰasaraxu	ʤɑsrɑx
ǰasilxu	ʤæʃlɑx
ǰadaixu	ʤɑdɪːx
ǰadagailaxu	ʤɑdɡæːlɑx
ǰadagaidaxu	ʤɑdɡæːdɑx
ǰadagairaxu	ʤɑdɡæːrɑx
ǰadalxu	ʤɑdlɑx
ǰadaraxu	ʤɑdrɑx
ǰadaragulxu	ʤɑdrʊːlɑx
ǰaduudaxu	ʤɑːdʊːdɑx
ǰadraxu	ʤɑdrɑx
ǰaǰagadaxu	ʤɑʤɡɑdɑx
ǰaǰilxu	ʤæʤlɑx
ǰayagaxu	ʤɪjɑːx
ǰayadaxu	ʤɑjdɑx
ǰaruxu	ʤɑrɑx
ǰarugdaxu	ʤɑrɑɡdɑx
ǰaručagulxu	ʤɑrʧʊːlɑx
ǰaručalaxu	ʤɑrʧlɑx
ǰargulaxu	ʤɑrɡɑlɑx
ǰargulduxu	ʤɑrɡɑldɑx
ǰarmalaxu	ʤɑrɑmlɑx
ǰarlaxu	ʤɑrlɑx
ǰarliglaxu	ʤærlɑɡlɑx
ǰarligdaxu	ʤærlɑɡdɑx
ǰarčimlaxu	ʤærʧɪmlɑx
ǰenǰeixü	ʤinʤiːx
ǰenǰeilexü	ʤinʤiːləx
ǰenǰegenexü	ʤinʤiɡnəx
ǰenǰelǰexü	ʤinʤilʤix
ǰebelexü	ʤibləx
ǰebseglexü	ʤibsəɡləx
ǰebsegčilexü	ʤibsəɡʧləx
ǰebsegǰixü	ʤibsəɡʤix
ǰexeidexü	ʤixiːdəx
ǰexexü	ʤəxəx
ǰegǰeixü	ʤiɡʤiːx
ǰegeglexü	ʤəːɡləx
ǰegegexü	ʤəːɡəx
ǰegetüüdexü	ʤəːtuːdəx
ǰegünsilexü	ʤuːnʃləx
ǰegübčilexü	ʤuːbʧləx
ǰegüxü	ʤuːx
ǰegülexü	ʤuːləx
ǰegülgexü	ʤuːlɡəx
ǰegüdexü	ʤuːdəx
ǰegüdülexü	ʤuːdləx
ǰegürmeglexü	ʤuːrməɡləx
ǰemdeglexü	ʤimdəɡləx
ǰelelexü	ʤilləx
ǰedxerlexü	ʤitɡərləx
ǰedlexü	ʤidləx
ǰergelexü	ʤirəɡləx
ǰergelgetüxü	ʤirɡəlɡəːtəx
ǰergečexü	ʤirəɡʧix
ǰergečegülxü	ʤirəɡʧuːləx
ǰermeixü	ʤirmiːx
ǰermegenexü	ʤirməɡnəx
ǰermelǰexü	ʤirməlʤix
ǰerliglexü	ʤirləɡləx
ǰerligsixü	ʤirləɡʃix
ǰerteixü	ʤirtiːx
ǰertegenexü	ʤirtəɡnəx
ǰertelǰexü	ʤirtəlʤix
ǰintüülexü	ʤintuːləx
ǰiŋnexü	ʤiɡnəx
ǰiŋxinilexü	ʤiŋxənləx
ǰiŋxiničilexü	ʤiŋxənʧləx
ǰiŋxilexü	ʤiŋxləx
ǰiŋginexü	ʤiŋɡənəx
ǰiŋlexü	ʤiŋləx
ǰiŋdexü	ʤiŋdəx
ǰibarlaxu	ʤɪbɑrlɑx
ǰibegüčexü	ʤibuːʧix
ǰibegürexü	ʤibuːrəx
ǰibegürxexü	ʤibuːrxəx
ǰiberexü	ʤibrəx
ǰibxü	ʤibəx
ǰixegüčexü	ʤixuːʧix
ǰixegürexü	ʤixuːrəx
ǰixegürxexü	ʤixuːrxəx
ǰixirxü	ʤixrəx
ǰiglexü	ʤiɡləx
ǰigsixü	ʤiɡʃix
ǰigsigürexü	ʤiɡʃuːrəx
ǰigsiyexü	ʤiɡʃəːx
ǰigdelexü	ʤiɡdləx
ǰigderexü	ʤiɡdrəx
ǰigǰiixü	ʤiɡʤiːx
ǰigǰigenexü	ʤiɡʤiɡnəx
ǰigǰigürexü	ʤiɡʤuːrəx
ǰigaburilaxu	ʤɑːbɑrlɑx
ǰigaxu	ʤɑːx
ǰigalxilaxu	ʤɑːlxiːləx
ǰigasučilaxu	ʤɑɡɑsʧlɑx
ǰigelexü	ʤəːləx
ǰigelegülxü	ʤəːluːləx
ǰigeledxü	ʤəːldəx
ǰiginexü	ʤiːnəx
ǰigixü	ʤiːx
ǰigiriglexü	ʤiːrəɡləx
ǰiguxu	ʤʊːx
ǰigulčilaxu	ʤʊːlʧlɑx
ǰigutaxu	ʤʊɡtɑx
ǰigutagaxu	ʤʊɡtɑːx
ǰigučilaxu	ʤʊːʧlɑx
ǰiguraxu	ʤʊːrɑx
ǰiguralduxu	ʤʊːrɑldɑx
ǰigürlexü	ʤiɡuːrləx
ǰig°saxu	ʤɪɡsɑx
ǰig°sagaxu	ʤɪɡsɑːx
ǰimaǰaxu	ʤɪmʤɪx
ǰimelexü	ʤimləx
ǰimelčexü	ʤiməlʧix
ǰimiixü	ʤimiːx
ǰimislexü	ʤimsləx
ǰimüüsülexü	ʤimuːsləx
ǰimnexü	ʤimnəx
ǰimbürdexü	ʤimbərdəx
ǰimlexü	ʤimləx
ǰimseglexü	ʤimsəɡləx
ǰimǰiginexü	ʤimʤiɡnəx
ǰilabalǰaxu	ʤɪlbɑlʤɪx
ǰiliixü	ʤiliːx
ǰiliilgexü	ʤiliːlɡəx
ǰiliidexü	ʤiliːdəx
ǰilixü	ʤiləx
ǰilogodxu	ʤɔlɔːdɔx
ǰilogočilaxu	ʤɔlɔːʧlɔx
ǰilberxexü	ʤilbərxəx
ǰilbiŋtüxü	ʤilbəŋtəx
ǰilbitüxü	ʤiləbtəx
ǰilbirxexü	ʤilbərxəx
ǰilmaixu	ʤɪlmɪːx
ǰilmalǰaxu	ʤɪlmɑlʤɪx
ǰisexü	ʤisəx
ǰisixü	ʤiʃix
ǰisigexü	ʤiʃəːx
ǰisigülexü	ʤiʃuːləx
ǰisigüdexü	ʤiʃuːdəx
ǰisiyalaxu	ʤɪʃɑːlɑx
ǰisurlaxu	ʤʊsɑrlɑx
ǰisurdaxu	ʤʊsɑrdɑx
ǰisurčilaxu	ʤʊsɑrʧlɑx
ǰisülexü	ʤusləx
ǰišixü	ʤiʃix
ǰišigdexü	ʤiʃiɡdəx
ǰišilexü	ʤiʃləx
ǰišiyelexü	ʤiʃəːləx
ǰitögerxexü	ʤotoːrxox
ǰidalaxu	ʤɪdlɑx
ǰideürexü	ʤiduːrəx
ǰidxüxü	ʤutɡəx
ǰidlexü	ʤidləx
ǰiǰiglexü	ʤiʤiɡləx
ǰiǰigdexü	ʤiʤiɡdəx
ǰiǰigǰigülxü	ʤiʤiɡʤuːləx
ǰiǰigrexü	ʤiʤiɡrəx
ǰiǰiginaxu	ʤɪʤɪɡnɑx
ǰiǰigürlexü	ʤiʤuːrləx
ǰiyasalaxu	ʤɑːslɑx
ǰiriixü	ʤiriːx
ǰiriglexü	ʤiːrəɡləx
ǰirilǰexü	ʤirəlʤix
ǰirogalaxu	ʤɔrɔːlɔx
ǰiruxaičilaxu	ʤʊrxæːʧlɑx
ǰiruxalaxu	ʤʊrxlɑx
ǰiruxu	ʤʊrɑx
ǰirugadasulaxu	ʤʊrɑːdɑslɑx
ǰiruglaxu	ʤʊrɑɡlɑx
ǰirumnaxu	ʤʊrɑmnɑx
ǰirumlaxu	ʤʊrɑmlɑx
ǰirumsixu	ʤʊrɑmʃɪx
ǰirumǰixu	ʤʊrɑmʤɪx
ǰirumǰigulxu	ʤʊrɑmʤʊːlɑx
ǰirübelǰexü	ʤirbəlʤix
ǰirübbelǰexü	ʤirbəlʤix
ǰirüxelexü	ʤurxləx
ǰirüxesixü	ʤurxʃix
ǰirüxesiyexü	ʤurxʃəːx
ǰirbaganaxu	ʤɪrɑbɡɑnɑx
ǰirbalǰaxu	ʤɪrbɑlʤɪx
ǰirbiixü	ʤirbiːx
ǰirbixü	ʤirbəx
ǰirbiginexü	ʤirbəɡnəx
ǰirbilǰexü	ʤirbəlʤix
ǰirgaxu	ʤɪrɡɑx
ǰirgagaxu	ʤɪrɡɑːx
ǰirgelxü	ʤirəɡləx
ǰirgixü	ʤirɡəx
ǰirmaixu	ʤɪrmɪːx
ǰirmaganaxu	ʤɪrɑmɡɑnɑx
ǰirmalǰaxu	ʤɪrmɑlʤɪx
ǰirmeixü	ʤirmiːx
ǰirmegenexü	ʤirməɡnəx
ǰirmelǰexü	ʤirməlʤix
ǰirmüsülexü	ʤirəmsləx~ʤuəmsləx
ǰirtaixu	ʤɪrtɪːx
ǰirtabalǰaxu	ʤɪrtbɑlʤɪx
ǰirtaganaxu	ʤɪrtɡɑnɑx
ǰirtalǰaxu	ʤɪrtɑlʤɪx
ǰoŋxilaxu	ʤœŋxlɔx
ǰobanixu	ʤɔbnɔx
ǰobaxu	ʤɔbɔx
ǰobagaxu	ʤɔbɔːx
ǰobarilaxu	ʤɔbɔrlɔx
ǰoxixu	ʤœxɪx
ǰoxilduxu	ʤœxɪldɔx
ǰoxildugulxu	ʤœxɪldʊːlɑx
ǰoxičaxu	ʤœxʧɪx
ǰoxičagulxu	ʤœxʧʊːlɑx
ǰoxičalduxu	ʤœxʧɪldɔx
ǰoxiyaxu	ʤœxɪɔx
ǰoxiraxu	ʤœxrɔx
ǰogisxu	ʤœɡsɔx
ǰogoxu	ʤɔːx
ǰogogoxu	ʤɔɡɔːx
ǰogogxixü	ʤɔːɡxiːx
ǰogoglaxu	ʤɔːɡlɔx
ǰogogdaxu	ʤɔːɡdɔx
ǰogosorxaxu	ʤɔːsɔrxɔx
ǰogosxixü	ʤɔɡɔsxiːx
ǰogorilaxu	ʤœːrlɔx
ǰogsoŋgiraxu	ʤɔɡsɔŋɡɪrɔx
ǰogsoŋguiraxu	ʤɔɡsɔŋɡʊɪrɑx
ǰogsoxu	ʤɔɡsɔx
ǰogsoganaxu	ʤɔɡsɡɔnɔx
ǰogsogaxu	ʤɔɡsɔːx
ǰogsogalǰaxu	ʤɔɡsɡɔlʤɪx
ǰogsosxixü	ʤɔɡsɔsxiːx
ǰogdorlaxu	ʤɔɡdɔrlɔx
ǰogdordaxu	ʤɔɡdɔrdɔx
ǰomboixu	ʤɔmbɔɪx
ǰombogonaxu	ʤɔmbɔɡɔnɔx
ǰombolǰaxu	ʤɔmbɔlʤɪx
ǰolaxu	ʤɔːlɔx
ǰolixu	ʤœlɪx
ǰoliglaxu	ʤœlɪɡlɔx
ǰolbiŋnaxu	ʤœlbɔɡnɔx
ǰolbiŋtoxu	ʤœlbɔŋtɔx
ǰolbisiraxu	ʤœlɪbʃrɔx
ǰolbiraxu	ʤœlɪbrɔx
ǰolbirxaxu	ʤœlbɔrxɔx
ǰolgaxu	ʤɔlɡɔx
ǰolgagulxu	ʤɔlɡʊːlɑx
ǰosodaxu	ʤɔsdɔx
ǰodoxu	ʤɔdɔx
ǰodoglaxu	ʤɔdɔɡlɔx
ǰodolčaxu	ʤɔdɔlʧɪx
ǰočilaxu	ʤœʧlɔx
ǰočirxaxu	ʤœʧɪrxɔx
ǰoǰiixu	ʤœʤɪːx
ǰoǰiginaxu	ʤœʤɪɡnɔx
ǰoǰigraxu	ʤœʤɪɡrɔx
ǰorixu	ʤœrɪx
ǰorigulxu	ʤœrɪʊlɑx
ǰoriglaxu	ʤœrɪɡlɔx
ǰorigǰixu	ʤœrɪɡʤɪx
ǰorigǰigulxu	ʤœrɪɡʤʊːlɑx
ǰorimaglaxu	ʤœrmɔɡlɔx
ǰorxu	ʤɔrɔx
ǰorgoxu	ʤɔrɡɔx
ǰorčixu	ʤɔrʧɪx
ǰuigurlaxu	ʤʊɪɡɑrlɑx
ǰuubaixu	ʤʊːbɪːx
ǰuubaŋdaxu	ʤʊːbɑŋdɑx
ǰuubagardaxu	ʤʊːbɡɑrdɑx
ǰuuxalaxu	ʤʊːxlɑx
ǰuumaganaxu	ʤʊːmɡɑnɑx
ǰuumalǰaxu	ʤʊːmɑlʤɪx
ǰuulidaxu	ʤʊɪldɑx
ǰuuǰailaxu	ʤʊːʤæːlɑx
ǰuuǰaidaxu	ʤʊːʤæːdɑx
ǰunsixu	ʤʊnʃɪx
ǰunǰixu	ʤʊnʤɪx
ǰuŋgaglaxu	ʤʊŋɡɑɡlɑx
ǰuŋgagsixu	ʤʊŋɡɑɡʃɪx
ǰuŋgagtuxu	ʤʊŋɡɑɡtɑx
ǰuŋgagraxu	ʤʊŋɡɑɡrɑx
ǰubuxu	ʤʊbɑx
ǰubčagalaxu	ʤʊbʧɑːlɑx
ǰubčixu	ʤʊbʧɪx
ǰugalaxu	ʤʊɡɑːlɑx
ǰugačaxu	ʤʊɡɑːʧɪx
ǰugulxu	ʤʊɡlɑx
ǰuguraxu	ʤʊɡrɑx
ǰumaixu	ʤʊmɪːx
ǰumalaxu	ʤʊmlɑx
ǰumalǰaxu	ʤʊmɑlʤɪx
ǰumaraxu	ʤʊmrɑx
ǰumbaixu	ʤʊmbɪːx
ǰuluxu	ʤʊlɑx
ǰulbaxu	ʤʊlbɑx
ǰulbuixu	ʤʊlbɪːx
ǰulbuxu	ʤʊlbɑx
ǰulbuganaxu	ʤʊlɑbɡɑnɑx
ǰulbulxu	ʤʊlɑblɑx
ǰulbudasulaxu	ʤʊlɑbdɑslɑx
ǰulgagaxu	ʤʊlɡɑːx
ǰulgalxu	ʤʊlɡɑlɑx
ǰulgaraxu	ʤʊlɡɑrɑx
ǰulguidaxu	ʤʊlɡʊɪdɑx
ǰuldaxu	ʤʊldɑx
ǰulčiixu	ʤʊlʧɪːx
ǰulčilǰaxu	ʤʊlʧɪlʤɪx
ǰulǰagalaxu	ʤʊlʤɪɡlɑx
ǰusaxu	ʤʊsɑx
ǰusuxu	ʤʊsɑx
ǰutaŋsixu	ʤʊtɑŋʃɪx
ǰutaxu	ʤʊtɑx
ǰutaraxu	ʤʊtrɑx
ǰudalxu	ʤʊdlɑx
ǰudačixu	ʤʊdʧɪx
ǰudaraxu	ʤʊdrɑx
ǰudlaxu	ʤʊdlɑx
ǰudraxu	ʤʊdrɑx
ǰuǰaixu	ʤʊʤɪːx
ǰuǰagalaxu	ʤʊʤɑːlɑx
ǰuǰagadaxu	ʤʊʤɑːdɑx
ǰuǰagadxaxu	ʤʊʤɑːtɡɑx
ǰuǰagadxu	ʤʊʤɑːtɑx
ǰuǰagaraxu	ʤʊʤɑːrɑx
ǰurbuslaxu	ʤʊrbɑslɑx
ǰurbusčilaxu	ʤʊrbɑsʧlɑx
ǰursixu	ʤʊrʃɪx
ǰursiǰigulxu	ʤʊrʃʤʊːlɑx
ǰönöxü	ʤonox
ǰönöglexü	ʤonoɡlox
ǰönögsixü	ʤonoɡʃix
ǰönögrexü	ʤonoɡrox
ǰönötöxü	ʤontox
ǰönötöglexü	ʤontoɡlox
ǰöntöxü	ʤontox
ǰöŋnexü	ʤoɡnox
ǰöŋgexü	ʤoŋɡox
ǰöblexü	ʤoblox
ǰöbsixü	ʤobʃix
ǰöbsildüxü	ʤobʃildox
ǰöbsiyexü	ʤobʃoːx
ǰöbsiyerexü	ʤobʃoːrox
ǰöbtöxü	ʤobtox
ǰöbtögexü	ʤobtɡox
ǰöbdexü	ʤobdox
ǰöbdelčexü	ʤobdolʧix
ǰögeixü	ʤoɡoix
ǰögegsixü	ʤoːɡʃix
ǰögegsirexü	ʤoːɡʃrox
ǰögegtüxü	ʤoːɡtox
ǰögegebürilexü	ʤoːborlox
ǰögegexü	ʤoːx
ǰögelelexü	ʤoːllox
ǰögelesixü	ʤoːlʃix
ǰögeledexü	ʤoːldox
ǰögeledxexü	ʤoːltɡox
ǰögeledxü	ʤoːltox
ǰögelečilexü	ʤoːlʧlox
ǰögelerexü	ʤoːlrox
ǰögesxerexü	ʤoːsoɡrox
ǰögedxerexü	ʤoːtoɡrox
ǰögedxeregülxü	ʤoːtoɡruːləx
ǰögeriǰixü	ʤoːrʤix
ǰögögexü	ʤoːx
ǰöčixü	ʤoʧix
ǰöčigüdlexü	ʤoʧuːdləx
ǰöriixü	ʤoroix
ǰörixü	ʤorox
ǰörigülexü	ʤoruːləx
ǰörigüldexü	ʤoruːldəx
ǰörigüdexü	ʤoruːdəx
ǰörigüdlexü	ʤoruːdləx
ǰörildüxü	ʤoroldox
ǰörilčexü	ʤorolʧix
ǰöričexü	ʤorʧix
ǰöričeldüxü	ʤorʧildox
ǰüixü	ʤuix
ǰüilxü	ʤuiləx
ǰüillexü	ʤuilləx
ǰüilčilexü	ʤuilʧləx
ǰüidexü	ʤuidəx
ǰüičilexü	ʤuiʧləx
ǰüirlexü	ʤuirləx
ǰüxexü	ʤuxəx
ǰüglexü	ʤuɡləx
ǰüglegülxü	ʤuɡluːləx
ǰügsirexü	ʤuɡʃrəx
ǰügürmeglexü	ʤuːrməɡləx
ǰülegedexü	ʤuləɡdəx
ǰülgenixü	ʤuləɡnəx
ǰülgerexü	ʤuləɡrəx
ǰülgüxü	ʤulɡəx
ǰülgügürdexü	ʤulɡuːrdəx
ǰüldelexü	ʤuldləx
ǰülčiixü	ʤulʧiːx
ǰülčigerdexü	ʤulʧɡərdəx
ǰülčilǰexü	ʤulʧilʤix
ǰüserexü	ʤusrəx
ǰüsüxü	ʤusəx
ǰüsügülxü	ʤusuːləx
ǰüsügürdexü	ʤusuːrdəx
ǰüsümlexü	ʤusəmləx
ǰüdeŋgirexü	ʤudəŋɡərəx
ǰüdexü	ʤudəx
ǰüderexü	ʤudrəx
ǰüčügelexü	ʤuʤiɡləx
ǰürmelexü	ʤurəmləx
yaibaixu	jæːbɪːx
yaibaganaxu	jæːbɡɑnɑx
yaibalǰaxu	jæːbɑlʤɪx
yaiǰiixu	jæːʤɪːx
yaiǰiganaxu	jæːʤɡɑnɑx
yaiǰilǰaxu	jæːʤɪlʤɪx
yairaxu	jæːrɑx
yandaxu	jɑndɑx
yandaglaxu	jɑndɑɡlɑx
yaŋnaxu	jɑɡnɑx
yaŋbalaxu	jɑmbɑlɑx
yaŋxandaxu	jɑŋxɑndɑx
yaŋxalaxu	jɑŋxlɑx
yaŋxiixu	jæŋxɪːx
yaŋxigardaxu	jæŋxɡɑrdɑx
yaŋginaxu	jæŋɡɪnɑx
yaŋgulaxu	jɑŋɡʊːlɑx
yaŋgurxaxu	jɑŋɡʊːrxɑx
yaŋsaxu	jɑŋsɑx
yaŋsixu	jɑŋʃɪx
yaŋsiyadaxu	jɑŋʃɑːdɑx
yaŋǰulaxu	jɑnʤlɑx~jɑŋslɑx
yaŋǰurxaxu	jɑnʤɪrxɑx~jɑŋsɑrxɑx
yabagalaxu	jɑbɡɑlɑx
yabagadaxu	jɑbɡɑdɑx
yabagaraxu	jɑbɡɑrɑx
yabaraxu	jɑːbɑːrɑx
yabiginaxu	jæbɪɡnɑx
yabuxu	jɑbɑx
yabugulxu	jɑbʊːlɑx
yabugdaxu	jɑbɑɡdɑx
yabulduxu	jɑbɑldɑx
yabulčaxu	jɑbɑlʧɪx
yabsixu	jɑbʃɪx
yaxixu	jɑːx
yaxirxu	jæxrɑx
yaxirlaxu	jæxɪrlɑx
yaxirdaxu	jæxɪrdɑx
yagaxixu	jɑːx
yagaraudaxu	jɑːrʊːdɑx
yagarabčilaxu	jɑːrɑbʧlɑx
yagaraxu	jɑɡɑːrɑx
yagaraxu	jɑːrɑx
yagaragulxu	jɑːrʊːlɑx
yagiraxu	jæɡrɑx
yaglaxu	jɑɡlɑx
yagsixu	jɑɡʃɪx
yagsiraxu	jɑɡʃrɑx
yagdaxu	jɑɡdɑx
yagǰaixu	jɑɡʤɪːx
yamatuxu	jɑmtɑx
yamarčilaxu	jɑmɑrʧlɑx
yamulaxu	jɑːmlɑx
yambalaxu	jɑmbɑlɑx
yambarčilaxu	jɑmbɑrʧlɑx
yalalaxu	jɑllɑx
yaladaxu	jɑldɑx
yaliyaxu	jælɪɑx
yasulaxu	jɑslɑx
yasuǰixu	jɑsʤɪx
yatugadaxu	jɑtɡɑdɑx
yadaŋgidaxu	jɑdɑŋɡɪdɑx
yadaŋgiraxu	jɑdɑŋɡɪrɑx
yadaxu	jɑdɑx
yadaguraxu	jɑdʊːrɑx
yadaraxu	jɑdrɑx
yayatuxu	jɑːjɑːtɑx
yarasixu	jɑrʃɪx
yaratuxu	jɑrtɑx
yarixu	jærɪx
yariglaxu	jærɪɡlɑx
yarilčaxu	jærɪlʧɪx
yariyačilaxu	jærɪɑʧlɑx
yarbiglaxu	jærbɑɡlɑx
yargalaxu	jɑrɡɑlɑx
yargixu	jærɡɪx
yarsiglaxu	jærʃɪɡlɑx
yardaglaxu	jɑrdɑɡlɑx
yeüǰilexü	juːʤləx
yenderlexü	indərləx
yexeürexü	ixuːrəx
yexebčilexü	ixəbʧləx
yexegerlexü	ixəːrləx
yexegürexü	ixuːrəx
yexegürxexü	ixuːrxəx
yexemsüglexü	ixəmsəɡləx
yexesxexü	ixsɡəx
yexesxü	ixsəx
yexedexü	ixdəx
yexedxexü	ixtɡəx
yexedxü	ixtəx
yexerxexü	ixərxəx
yexerxeglexü	ixərxəɡləx
yegülexü	juːləx
yegüdxexü	juːtɡəx
yegüdxü	juːtəx
yegürexü	juːrəx
yerüŋxeibčilexü	joroŋxøːbʧlox
yerüŋxeilexü	joroŋxøːlox
yerümdeglexü	joromdoɡlox
yintüxü	jintəx
yinǰüüdexü	jinʤuːdəx
yisülexü	joslox~jisləx
yoilaxu	jɔːlɔx
yoolaxu	jɔːlɔx
yontoixu	jɔntɔɪx
yontogonaxu	jɔntɡɔnɔx
yontolǰaxu	jɔntɔlʤɪx
yoŋxiixu	jœŋxɪːx
yoŋxoixu	jɔŋxɔɪx
yoŋxogonaxu	jɔŋxɡɔnɔx
yoŋxolǰaxu	jɔŋxɔlʤɪx
yobočixu	jɔbʧɪx
yoborxilaxu	jɔbɔrxiːləx
yoborxu	jɔbrɔx
yoxolaxu	jɔxlɔx
yogtalaxu	jɔɡtlɔx
yomboixu	jɔmbɔɪx
yolooxu	jɔlɔːx
yolboixu	jɔlbɔɪx
yolbogordaxu	jɔlɔbɡɔrdɔx
yolxoixu	jɔlxɔɪx
yolxogonaxu	jɔlxɡɔnɔx
yolxolǰaxu	jɔlxɔlʤɪx
yolxodasulaxu	jɔlxdɔslɔx
yolčoixu	jɔlʧɪːx
yolčogonaxu	jɔlʧɡɔnɔx
yolčolǰaxu	jɔlʧɪlʤɪx
yosolaxu	jɔslɔx
yosočilaxu	jɔsʧlɔx
yosorxaxu	jɔsɔrxɔx
yoǰolaxu	jɔʤlɔx
yorolaxu	jɔrlɔx
yorgixu	jœrɡɪx
yuguxu	jʊɡɑx
yugugixu	jʊːɡɪx
yögexü	joɡox
yögelexü	joɡoːlox
yögetüxü	joɡoːtox
yögedexü	joɡoːdox
yögerexü	joɡoːrox
yörgexü	jorɡox
yörgeldüxü	jorɡoldox
yüŋxüixü	juŋxiːx
yülxüixü	julxiːx
yülxügenexü	julxəɡnəx
yülxülǰexü	julxəlʤix
rasiyalaxu	ɑrʃɑːlɑx
wagarlaxu	wɑːrlɑx
waglaxu	wɑːɡlɑx
walaxu	wɑːlɑx
watuxu	wɑːtɑx
wadaŋnaxu	wɑːdɑɡnɑx
wadaŋlaxu	wɑːdɑŋlɑx~wɑːdlɑx
fašisčilaxu	fɑʃisʧlɑx
kart'laxu	kɑːrtlɑx
koloničilaxu	kɔlɔːnʧlɔx
kod'laxu	kɔːdlɔx
